subst:pl:nom:f	Case=Nom|Gender=Fem|Number=Plur
prep:loc:nwok	AdpType=Prep|Variant=Short
adj:pl:loc:m3:pos	Animacy=Inan|Case=Loc|Degree=Pos|Gender=Masc|Number=Plur
subst:pl:loc:m3	Animacy=Inan|Case=Loc|Gender=Masc|Number=Plur
conj	_
subst:pl:loc:f	Case=Loc|Gender=Fem|Number=Plur
prep:loc	AdpType=Prep
fin:pl:ter:imperf	Aspect=Imp|Mood=Ind|Number=Plur|Person=3|Tense=Pres|VerbForm=Fin|Voice=Act
adj:sg:loc:f:pos	Case=Loc|Degree=Pos|Gender=Fem|Number=Sing
subst:sg:loc:f	Case=Loc|Gender=Fem|Number=Sing
interp	PunctType=Peri
subst:sg:nom:m2	Animacy=Nhum|Case=Nom|Gender=Masc|Number=Sing
fin:sg:ter:imperf	Aspect=Imp|Mood=Ind|Number=Sing|Person=3|Tense=Pres|VerbForm=Fin|Voice=Act
prep:inst:nwok	AdpType=Prep|Variant=Short
adj:sg:inst:f:pos	Case=Ins|Degree=Pos|Gender=Fem|Number=Sing
subst:sg:inst:f	Case=Ins|Gender=Fem|Number=Sing
subst:sg:loc:m3	Animacy=Inan|Case=Loc|Gender=Masc|Number=Sing
num:pl:nom:f:congr	Case=Nom|Gender=Fem|Number=Plur|NumForm=Word
subst:pl:inst:n:pt	Case=Ins|Gender=Neut|Number=Ptan
adj:sg:nom:f:pos	Case=Nom|Degree=Pos|Gender=Fem|Number=Sing
prep:gen:nwok	AdpType=Prep|Variant=Short
ppron3:pl:gen:f:ter:akc:praep	Case=Gen|Gender=Fem|Number=Plur|Person=3|PrepCase=Pre|PronType=Prs|Variant=Long
subst:sg:acc:f	Case=Acc|Gender=Fem|Number=Sing
subst:sg:acc:m2	Animacy=Nhum|Case=Acc|Gender=Masc|Number=Sing
adj:sg:nom:m1:pos	Animacy=Hum|Case=Nom|Degree=Pos|Gender=Masc|Number=Sing
subst:sg:nom:m1	Animacy=Hum|Case=Nom|Gender=Masc|Number=Sing
pcon:imperf	Aspect=Imp|Tense=Pres|VerbForm=Conv|Voice=Act
siebie:inst	Case=Ins|PronType=Prs|Reflex=Yes
adj:sg:acc:m3:pos	Animacy=Inan|Case=Acc|Degree=Pos|Gender=Masc|Number=Sing
subst:sg:acc:m3	Animacy=Inan|Case=Acc|Gender=Masc|Number=Sing
num:pl:nom:f:rec	Case=Nom|Gender=Fem|Number=Plur|NumType=Card|PronType=Ind
subst:pl:gen:f	Case=Gen|Gender=Fem|Number=Plur
adj:pl:inst:m3:pos	Animacy=Inan|Case=Ins|Degree=Pos|Gender=Masc|Number=Plur
subst:pl:inst:m3	Animacy=Inan|Case=Ins|Gender=Masc|Number=Plur
subst:sg:nom:f	Case=Nom|Gender=Fem|Number=Sing
ppas:pl:inst:n:perf:aff	Aspect=Perf|Case=Ins|Gender=Neut|Number=Plur|Polarity=Pos|VerbForm=Part|Voice=Pass
subst:pl:inst:n:ncol	Case=Ins|Gender=Neut|Number=Plur
prep:acc:nwok	AdpType=Prep|Variant=Short
subst:sg:gen:n:ncol	Case=Gen|Gender=Neut|Number=Sing
prep:dat	AdpType=Prep
siebie:dat	Case=Dat|PronType=Prs|Reflex=Yes
adj:sg:nom:m2:pos	Animacy=Nhum|Case=Nom|Degree=Pos|Gender=Masc|Number=Sing
prep:inst:wok	AdpType=Prep|Variant=Long
adj:sg:loc:m3:pos	Animacy=Inan|Case=Loc|Degree=Pos|Gender=Masc|Number=Sing
subst:pl:loc:m2	Animacy=Nhum|Case=Loc|Gender=Masc|Number=Plur
prep:gen	AdpType=Prep
ppas:sg:gen:f:perf:aff	Aspect=Perf|Case=Gen|Gender=Fem|Number=Sing|Polarity=Pos|VerbForm=Part|Voice=Pass
subst:sg:gen:f	Case=Gen|Gender=Fem|Number=Sing
subst:sg:inst:m3	Animacy=Inan|Case=Ins|Gender=Masc|Number=Sing
adv	_
subst:sg:inst:m2	Animacy=Nhum|Case=Ins|Gender=Masc|Number=Sing
subst:pl:loc:n:pt	Case=Loc|Gender=Neut|Number=Ptan
pact:sg:inst:m2:imperf:aff	Animacy=Nhum|Aspect=Imp|Case=Ins|Gender=Masc|Number=Sing|Polarity=Pos|VerbForm=Part|Voice=Act
adj:pl:loc:n:pos	Case=Loc|Degree=Pos|Gender=Neut|Number=Plur
num:pl:nom:n:rec:ncol	Case=Nom|Gender=Neut|Number=Plur|NumType=Card|PronType=Ind
subst:pl:gen:n:col	Case=Gen|Gender=Neut|Number=Plur|NumType=Sets
ppas:sg:loc:f:perf:aff	Aspect=Perf|Case=Loc|Gender=Fem|Number=Sing|Polarity=Pos|VerbForm=Part|Voice=Pass
ppas:sg:loc:f:imperf:aff	Aspect=Imp|Case=Loc|Gender=Fem|Number=Sing|Polarity=Pos|VerbForm=Part|Voice=Pass
adj:pl:loc:f:pos	Case=Loc|Degree=Pos|Gender=Fem|Number=Plur
ppas:sg:loc:n:imperf:aff	Aspect=Imp|Case=Loc|Gender=Neut|Number=Sing|Polarity=Pos|VerbForm=Part|Voice=Pass
subst:sg:loc:n:ncol	Case=Loc|Gender=Neut|Number=Sing
prep:gen:wok	AdpType=Prep|Variant=Long
adj:sg:gen:f:pos	Case=Gen|Degree=Pos|Gender=Fem|Number=Sing
adj:sg:inst:m3:pos	Animacy=Inan|Case=Ins|Degree=Pos|Gender=Masc|Number=Sing
ppas:sg:inst:f:perf:aff	Aspect=Perf|Case=Ins|Gender=Fem|Number=Sing|Polarity=Pos|VerbForm=Part|Voice=Pass
part	_
pact:sg:gen:f:imperf:aff	Aspect=Imp|Case=Gen|Gender=Fem|Number=Sing|Polarity=Pos|VerbForm=Part|Voice=Act
adj:sg:acc:m1:pos	Animacy=Hum|Case=Acc|Degree=Pos|Gender=Masc|Number=Sing
subst:sg:acc:m1	Animacy=Hum|Case=Acc|Gender=Masc|Number=Sing
prep:acc	AdpType=Prep
subst:sg:acc:n:ncol	Case=Acc|Gender=Neut|Number=Sing
num:pl:nom:m1:rec	Animacy=Hum|Case=Nom|Gender=Masc|Number=Plur|NumForm=Word
subst:pl:gen:m1	Animacy=Hum|Case=Gen|Gender=Masc|Number=Plur
subst:sg:nom:n:col	Case=Nom|Gender=Neut|Number=Sing|NumType=Sets
adja	Hyph=Yes
adj:sg:gen:m2:pos	Animacy=Nhum|Case=Gen|Degree=Pos|Gender=Masc|Number=Sing
subst:sg:gen:m2	Animacy=Nhum|Case=Gen|Gender=Masc|Number=Sing
num:pl:loc:f:congr	Case=Loc|Gender=Fem|Number=Plur|NumForm=Word
prep:inst	AdpType=Prep
adj:sg:inst:m1:pos	Animacy=Hum|Case=Ins|Degree=Pos|Gender=Masc|Number=Sing
subst:pl:inst:f	Case=Ins|Gender=Fem|Number=Plur
adj:sg:gen:m3:pos	Animacy=Inan|Case=Gen|Degree=Pos|Gender=Masc|Number=Sing
subst:sg:gen:m3	Animacy=Inan|Case=Gen|Gender=Masc|Number=Sing
adj:pl:gen:m1:pos	Animacy=Hum|Case=Gen|Degree=Pos|Gender=Masc|Number=Plur
pact:sg:acc:f:imperf:aff	Aspect=Imp|Case=Acc|Gender=Fem|Number=Sing|Polarity=Pos|VerbForm=Part|Voice=Act
subst:sg:inst:n:col	Case=Ins|Gender=Neut|Number=Sing|NumType=Sets
subst:pl:gen:m3	Animacy=Inan|Case=Gen|Gender=Masc|Number=Plur
adj:pl:inst:n:pos	Case=Ins|Degree=Pos|Gender=Neut|Number=Plur
subst:pl:inst:n:col	Case=Ins|Gender=Neut|Number=Plur|NumType=Sets
adv:pos	Degree=Pos
pact:sg:loc:n:imperf:aff	Aspect=Imp|Case=Loc|Gender=Neut|Number=Sing|Polarity=Pos|VerbForm=Part|Voice=Act
adj:pl:nom:f:pos	Case=Nom|Degree=Pos|Gender=Fem|Number=Plur
siebie:gen	Case=Gen|PronType=Prs|Reflex=Yes
ppas:sg:acc:m3:imperf:aff	Animacy=Inan|Aspect=Imp|Case=Acc|Gender=Masc|Number=Sing|Polarity=Pos|VerbForm=Part|Voice=Pass
adj:sg:acc:n:pos	Case=Acc|Degree=Pos|Gender=Neut|Number=Sing
adj:sg:gen:n:pos	Case=Gen|Degree=Pos|Gender=Neut|Number=Sing
ppas:sg:nom:m2:perf:aff	Animacy=Nhum|Aspect=Perf|Case=Nom|Gender=Masc|Number=Sing|Polarity=Pos|VerbForm=Part|Voice=Pass
num:pl:nom:n:rec:col	Case=Nom|Gender=Neut|Number=Plur|NumForm=Word|NumType=Sets
num:pl:gen:f:congr	Case=Gen|Gender=Fem|Number=Plur|NumForm=Word
adj:pl:gen:f:pos	Case=Gen|Degree=Pos|Gender=Fem|Number=Plur
pact:pl:gen:f:imperf:aff	Aspect=Imp|Case=Gen|Gender=Fem|Number=Plur|Polarity=Pos|VerbForm=Part|Voice=Act
ppas:sg:loc:m3:perf:aff	Animacy=Inan|Aspect=Perf|Case=Loc|Gender=Masc|Number=Sing|Polarity=Pos|VerbForm=Part|Voice=Pass
num:pl:nom:m2:congr	Animacy=Nhum|Case=Nom|Gender=Masc|Number=Plur|NumForm=Word
subst:pl:nom:m2	Animacy=Nhum|Case=Nom|Gender=Masc|Number=Plur
ppas:pl:loc:m3:imperf:aff	Animacy=Inan|Aspect=Imp|Case=Loc|Gender=Masc|Number=Plur|Polarity=Pos|VerbForm=Part|Voice=Pass
ppas:sg:nom:m1:perf:aff	Animacy=Hum|Aspect=Perf|Case=Nom|Gender=Masc|Number=Sing|Polarity=Pos|VerbForm=Part|Voice=Pass
adj:pl:gen:n:pos	Case=Gen|Degree=Pos|Gender=Neut|Number=Plur
pact:pl:gen:n:imperf:aff	Aspect=Imp|Case=Gen|Gender=Neut|Number=Plur|Polarity=Pos|VerbForm=Part|Voice=Act
adj:sg:acc:f:pos	Case=Acc|Degree=Pos|Gender=Fem|Number=Sing
ppas:sg:nom:f:perf:aff	Aspect=Perf|Case=Nom|Gender=Fem|Number=Sing|Polarity=Pos|VerbForm=Part|Voice=Pass
ppas:pl:gen:m1:perf:aff	Animacy=Hum|Aspect=Perf|Case=Gen|Gender=Masc|Number=Plur|Polarity=Pos|VerbForm=Part|Voice=Pass
subst:pl:acc:n:ncol	Case=Acc|Gender=Neut|Number=Plur
pact:pl:acc:n:imperf:aff	Aspect=Imp|Case=Acc|Gender=Neut|Number=Plur|Polarity=Pos|VerbForm=Part|Voice=Act
ppas:sg:loc:n:perf:aff	Aspect=Perf|Case=Loc|Gender=Neut|Number=Sing|Polarity=Pos|VerbForm=Part|Voice=Pass
adj:sg:inst:n:pos	Case=Ins|Degree=Pos|Gender=Neut|Number=Sing
subst:sg:inst:n:ncol	Case=Ins|Gender=Neut|Number=Sing
num:pl:nom:m1:congr	Animacy=Hum|Case=Nom|Gender=Masc|Number=Plur|NumForm=Word
subst:pl:nom:m1	Animacy=Hum|Case=Nom|Gender=Masc|Number=Plur
subst:pl:acc:f	Case=Acc|Gender=Fem|Number=Plur
ppas:sg:nom:m1:imperf:aff	Animacy=Hum|Aspect=Imp|Case=Nom|Gender=Masc|Number=Sing|Polarity=Pos|VerbForm=Part|Voice=Pass
adv:com	Degree=Cmp
pact:sg:nom:f:imperf:aff	Aspect=Imp|Case=Nom|Gender=Fem|Number=Sing|Polarity=Pos|VerbForm=Part|Voice=Act
ppron3:sg:gen:m2:ter:akc:praep	Animacy=Nhum|Case=Gen|Gender=Masc|Number=Sing|Person=3|PrepCase=Pre|PronType=Prs|Variant=Long
subst:pl:nom:m3	Animacy=Inan|Case=Nom|Gender=Masc|Number=Plur
subst:pl:loc:n:ncol	Case=Loc|Gender=Neut|Number=Plur
ppas:pl:loc:m2:perf:aff	Animacy=Nhum|Aspect=Perf|Case=Loc|Gender=Masc|Number=Plur|Polarity=Pos|VerbForm=Part|Voice=Pass
ppas:pl:gen:f:perf:aff	Aspect=Perf|Case=Gen|Gender=Fem|Number=Plur|Polarity=Pos|VerbForm=Part|Voice=Pass
adj:sg:loc:n:pos	Case=Loc|Degree=Pos|Gender=Neut|Number=Sing
pact:sg:nom:m1:imperf:aff	Animacy=Hum|Aspect=Imp|Case=Nom|Gender=Masc|Number=Sing|Polarity=Pos|VerbForm=Part|Voice=Act
adj:sg:nom:m3:pos	Animacy=Inan|Case=Nom|Degree=Pos|Gender=Masc|Number=Sing
subst:sg:nom:m3	Animacy=Inan|Case=Nom|Gender=Masc|Number=Sing
subst:pl:gen:n:ncol	Case=Gen|Gender=Neut|Number=Plur
ppas:sg:nom:f:imperf:aff	Aspect=Imp|Case=Nom|Gender=Fem|Number=Sing|Polarity=Pos|VerbForm=Part|Voice=Pass
adj:pl:acc:m1:pos	Animacy=Hum|Case=Acc|Degree=Pos|Gender=Masc|Number=Plur
subst:pl:acc:m1	Animacy=Hum|Case=Acc|Gender=Masc|Number=Plur
ppron3:sg:inst:m1:ter:akc:praep	Animacy=Hum|Case=Ins|Gender=Masc|Number=Sing|Person=3|PrepCase=Pre|PronType=Prs|Variant=Long
comp	_
adj:sg:inst:m2:pos	Animacy=Nhum|Case=Ins|Degree=Pos|Gender=Masc|Number=Sing
subst:sg:acc:n:col	Case=Acc|Gender=Neut|Number=Sing|NumType=Sets
pact:sg:acc:n:imperf:aff	Aspect=Imp|Case=Acc|Gender=Neut|Number=Sing|Polarity=Pos|VerbForm=Part|Voice=Act
ppas:sg:inst:m2:perf:aff	Animacy=Nhum|Aspect=Perf|Case=Ins|Gender=Masc|Number=Sing|Polarity=Pos|VerbForm=Part|Voice=Pass
adj:sg:nom:f:com	Case=Nom|Degree=Cmp|Gender=Fem|Number=Sing
num:pl:inst:m3:congr	Animacy=Inan|Case=Ins|Gender=Masc|Number=Plur|NumForm=Word
ppas:pl:loc:f:perf:aff	Aspect=Perf|Case=Loc|Gender=Fem|Number=Plur|Polarity=Pos|VerbForm=Part|Voice=Pass
ppron3:sg:gen:m1:ter:akc:praep	Animacy=Hum|Case=Gen|Gender=Masc|Number=Sing|Person=3|PrepCase=Pre|PronType=Prs|Variant=Long
adj:sg:nom:m1:com	Animacy=Hum|Case=Nom|Degree=Cmp|Gender=Masc|Number=Sing
subst:sg:inst:m1	Animacy=Hum|Case=Ins|Gender=Masc|Number=Sing
subst:sg:nom:n:ncol	Case=Nom|Gender=Neut|Number=Sing
ppron3:sg:gen:f:ter:akc:praep	Case=Gen|Gender=Fem|Number=Sing|Person=3|PrepCase=Pre|PronType=Prs|Variant=Long
ppas:pl:inst:f:perf:aff	Aspect=Perf|Case=Ins|Gender=Fem|Number=Plur|Polarity=Pos|VerbForm=Part|Voice=Pass
subst:sg:loc:m2	Animacy=Nhum|Case=Loc|Gender=Masc|Number=Sing
subst:pl:acc:m3	Animacy=Inan|Case=Acc|Gender=Masc|Number=Plur
adj:pl:nom:m3:pos	Animacy=Inan|Case=Nom|Degree=Pos|Gender=Masc|Number=Plur
ppas:pl:gen:n:perf:aff	Aspect=Perf|Case=Gen|Gender=Neut|Number=Plur|Polarity=Pos|VerbForm=Part|Voice=Pass
adj:pl:gen:m2:pos	Animacy=Nhum|Case=Gen|Degree=Pos|Gender=Masc|Number=Plur
subst:pl:gen:m2	Animacy=Nhum|Case=Gen|Gender=Masc|Number=Plur
adj:sg:nom:n:pos	Case=Nom|Degree=Pos|Gender=Neut|Number=Sing
subst:sg:dat:m1	Animacy=Hum|Case=Dat|Gender=Masc|Number=Sing
ppron3:sg:acc:m3:ter:akc:praep	Animacy=Inan|Case=Acc|Gender=Masc|Number=Sing|Person=3|PrepCase=Pre|PronType=Prs|Variant=Long
num:pl:acc:f:rec	Case=Acc|Gender=Fem|Number=Plur|NumType=Card|PronType=Ind
ppas:sg:gen:n:imperf:aff	Aspect=Imp|Case=Gen|Gender=Neut|Number=Sing|Polarity=Pos|VerbForm=Part|Voice=Pass
pact:pl:nom:f:imperf:aff	Aspect=Imp|Case=Nom|Gender=Fem|Number=Plur|Polarity=Pos|VerbForm=Part|Voice=Act
ppron3:sg:dat:m1:ter:nakc:npraep	Animacy=Hum|Case=Dat|Gender=Masc|Number=Sing|Person=3|PrepCase=Npr|PronType=Prs|Variant=Short
siebie:acc	Case=Acc|PronType=Prs|Reflex=Yes
ppron3:sg:gen:m1:ter:akc:npraep	Animacy=Hum|Case=Gen|Gender=Masc|Number=Sing|Person=3|PrepCase=Npr|PronType=Prs|Variant=Long
adj:pl:acc:f:pos	Case=Acc|Degree=Pos|Gender=Fem|Number=Plur
adj:pl:acc:n:pos	Case=Acc|Degree=Pos|Gender=Neut|Number=Plur
num:pl:inst:n:rec:col	Case=Ins|Gender=Neut|Number=Plur|NumForm=Word|NumType=Sets
ppron3:pl:gen:n:ter:akc:praep	Case=Gen|Gender=Neut|Number=Plur|Person=3|PrepCase=Pre|PronType=Prs|Variant=Long
ppas:sg:nom:m3:perf:aff	Animacy=Inan|Aspect=Perf|Case=Nom|Gender=Masc|Number=Sing|Polarity=Pos|VerbForm=Part|Voice=Pass
subst:sg:gen:m1	Animacy=Hum|Case=Gen|Gender=Masc|Number=Sing
ppas:sg:inst:m1:perf:aff	Animacy=Hum|Aspect=Perf|Case=Ins|Gender=Masc|Number=Sing|Polarity=Pos|VerbForm=Part|Voice=Pass
adj:sg:gen:m1:pos	Animacy=Hum|Case=Gen|Degree=Pos|Gender=Masc|Number=Sing
adj:pl:nom:m1:pos	Animacy=Hum|Case=Nom|Degree=Pos|Gender=Masc|Number=Plur
ppron3:pl:gen:m1:ter:akc:npraep	Animacy=Hum|Case=Gen|Gender=Masc|Number=Plur|Person=3|PrepCase=Npr|PronType=Prs|Variant=Long
subst:pl:acc:n:pt	Case=Acc|Gender=Neut|Number=Ptan
pact:sg:gen:m2:imperf:aff	Animacy=Nhum|Aspect=Imp|Case=Gen|Gender=Masc|Number=Sing|Polarity=Pos|VerbForm=Part|Voice=Act
adjp	PrepCase=Pre
ppas:sg:gen:m3:perf:aff	Animacy=Inan|Aspect=Perf|Case=Gen|Gender=Masc|Number=Sing|Polarity=Pos|VerbForm=Part|Voice=Pass
imps:perf	Aspect=Perf|Mood=Ind|Person=0|Tense=Past|VerbForm=Fin|Voice=Act
inf:perf	Aspect=Perf|VerbForm=Inf|Voice=Act
subst:sg:dat:m2	Animacy=Nhum|Case=Dat|Gender=Masc|Number=Sing
praet:sg:m3:imperf	Animacy=Inan|Aspect=Imp|Gender=Masc|Mood=Ind|Number=Sing|Tense=Past|VerbForm=Fin|Voice=Act
praet:sg:f:perf	Aspect=Perf|Gender=Fem|Mood=Ind|Number=Sing|Tense=Past|VerbForm=Fin|Voice=Act
imps:imperf	Aspect=Imp|Mood=Ind|Person=0|Tense=Past|VerbForm=Fin|Voice=Act
num:pl:acc:m3:rec	Animacy=Inan|Case=Acc|Gender=Masc|Number=Plur|NumForm=Digit|NumType=Card
pred	Mood=Ind|Tense=Pres|VerbForm=Fin|VerbType=Quasi
fin:pl:pri:imperf	Aspect=Imp|Mood=Ind|Number=Plur|Person=1|Tense=Pres|VerbForm=Fin|Voice=Act
inf:imperf	Aspect=Imp|VerbForm=Inf|Voice=Act
ppron12:sg:dat:m1:pri:akc	Animacy=Hum|Case=Dat|Gender=Masc|Number=Sing|Person=1|PronType=Prs|Variant=Long
None	_
praet:sg:m1:perf	Animacy=Hum|Aspect=Perf|Gender=Masc|Mood=Ind|Number=Sing|Tense=Past|VerbForm=Fin|Voice=Act
aglt:sg:pri:imperf:wok	Aspect=Imp|Clitic=Yes|Number=Sing|Person=1|Variant=Long
num:sg:acc:n:rec:ncol	Case=Acc|Gender=Neut|Number=Sing|NumType=Card|PronType=Ind
fin:sg:pri:imperf	Aspect=Imp|Mood=Ind|Number=Sing|Person=1|Tense=Pres|VerbForm=Fin|Voice=Act
fin:pl:pri:perf	Aspect=Perf|Mood=Ind|Number=Plur|Person=1|Tense=Fut|VerbForm=Fin|Voice=Act
adv:sup	Degree=Sup
adj:pl:gen:m3:pos	Animacy=Inan|Case=Gen|Degree=Pos|Gender=Masc|Number=Plur
impt:sg:sec:imperf	Aspect=Imp|Mood=Imp|Number=Sing|Person=2|VerbForm=Fin|Voice=Act
ppron12:sg:nom:m1:pri	Animacy=Hum|Case=Nom|Gender=Masc|Number=Sing|Person=1|PronType=Prs
fin:sg:pri:perf	Aspect=Perf|Mood=Ind|Number=Sing|Person=1|Tense=Fut|VerbForm=Fin|Voice=Act
fin:sg:ter:perf	Aspect=Perf|Mood=Ind|Number=Sing|Person=3|Tense=Fut|VerbForm=Fin|Voice=Act
adj:pl:inst:f:pos	Case=Ins|Degree=Pos|Gender=Fem|Number=Plur
fin:sg:sec:perf	Aspect=Perf|Mood=Ind|Number=Sing|Person=2|Tense=Fut|VerbForm=Fin|Voice=Act
fin:sg:sec:imperf	Aspect=Imp|Mood=Ind|Number=Sing|Person=2|Tense=Pres|VerbForm=Fin|Voice=Act
ppron12:pl:acc:m1:pri	Animacy=Hum|Case=Acc|Gender=Masc|Number=Plur|Person=1|PronType=Prs
subst:pl:nom:n:pt	Case=Nom|Gender=Neut|Number=Ptan
ppas:sg:acc:n:imperf:aff	Aspect=Imp|Case=Acc|Gender=Neut|Number=Sing|Polarity=Pos|VerbForm=Part|Voice=Pass
praet:sg:n:perf	Aspect=Perf|Gender=Neut|Mood=Ind|Number=Sing|Tense=Past|VerbForm=Fin|Voice=Act
praet:sg:n:imperf	Aspect=Imp|Gender=Neut|Mood=Ind|Number=Sing|Tense=Past|VerbForm=Fin|Voice=Act
pact:sg:gen:m1:imperf:aff	Animacy=Hum|Aspect=Imp|Case=Gen|Gender=Masc|Number=Sing|Polarity=Pos|VerbForm=Part|Voice=Act
aglt:sg:pri:imperf:nwok	Aspect=Imp|Clitic=Yes|Number=Sing|Person=1|Variant=Short
praet:pl:m1:imperf	Animacy=Hum|Aspect=Imp|Gender=Masc|Mood=Ind|Number=Plur|Tense=Past|VerbForm=Fin|Voice=Act
ppron3:sg:loc:f:ter:akc:praep	Case=Loc|Gender=Fem|Number=Sing|Person=3|PrepCase=Pre|PronType=Prs|Variant=Long
subst:pl:nom:m1:pt	Animacy=Hum|Case=Nom|Gender=Masc|Number=Ptan|PronType=Tot
praet:pl:m1:perf	Animacy=Hum|Aspect=Perf|Gender=Masc|Mood=Ind|Number=Plur|Tense=Past|VerbForm=Fin|Voice=Act
aglt:pl:pri:imperf:nwok	Aspect=Imp|Clitic=Yes|Number=Plur|Person=1|Variant=Short
impt:pl:pri:perf	Aspect=Perf|Mood=Imp|Number=Plur|Person=1|VerbForm=Fin|Voice=Act
adj:pl:acc:m3:pos	Animacy=Inan|Case=Acc|Degree=Pos|Gender=Masc|Number=Plur
praet:sg:f:imperf	Aspect=Imp|Gender=Fem|Mood=Ind|Number=Sing|Tense=Past|VerbForm=Fin|Voice=Act
praet:sg:m1:imperf	Animacy=Hum|Aspect=Imp|Gender=Masc|Mood=Ind|Number=Sing|Tense=Past|VerbForm=Fin|Voice=Act
fin:pl:sec:imperf	Aspect=Imp|Mood=Ind|Number=Plur|Person=2|Tense=Pres|VerbForm=Fin|Voice=Act
ppron3:pl:dat:f:ter:akc:npraep	Case=Dat|Gender=Fem|Number=Plur|Person=3|PrepCase=Npr|PronType=Prs|Variant=Long
ger:sg:acc:n:imperf:aff	Aspect=Imp|Case=Acc|Gender=Neut|Number=Sing|Polarity=Pos|VerbForm=Vnoun
bedzie:sg:ter:imperf	Aspect=Imp|Mood=Ind|Number=Sing|Person=3|Tense=Fut|VerbForm=Fin
praet:pl:f:perf	Aspect=Perf|Gender=Fem|Mood=Ind|Number=Plur|Tense=Past|VerbForm=Fin|Voice=Act
ppron3:sg:nom:m3:ter:akc:npraep	Animacy=Inan|Case=Nom|Gender=Masc|Number=Sing|Person=3|PrepCase=Npr|PronType=Prs|Variant=Long
praet:sg:m3:perf	Animacy=Inan|Aspect=Perf|Gender=Masc|Mood=Ind|Number=Sing|Tense=Past|VerbForm=Fin|Voice=Act
num:pl:acc:m3:congr	Animacy=Inan|Case=Acc|Gender=Masc|Number=Plur|NumForm=Word
praet:pl:n:perf	Aspect=Perf|Gender=Neut|Mood=Ind|Number=Plur|Tense=Past|VerbForm=Fin|Voice=Act
adj:pl:nom:n:pos	Case=Nom|Degree=Pos|Gender=Neut|Number=Plur
subst:pl:inst:m1	Animacy=Hum|Case=Ins|Gender=Masc|Number=Plur
ppron3:sg:gen:f:ter:akc:npraep	Case=Gen|Gender=Fem|Number=Sing|Person=3|PrepCase=Npr|PronType=Prs|Variant=Long
ppas:sg:acc:f:perf:aff	Aspect=Perf|Case=Acc|Gender=Fem|Number=Sing|Polarity=Pos|VerbForm=Part|Voice=Pass
ppron3:pl:gen:m1:ter:akc:praep	Animacy=Hum|Case=Gen|Gender=Masc|Number=Plur|Person=3|PrepCase=Pre|PronType=Prs|Variant=Long
num:pl:nom:m3:congr	Animacy=Inan|Case=Nom|Gender=Masc|Number=Plur|NumForm=Digit|NumType=Card
ger:sg:acc:n:perf:aff	Aspect=Perf|Case=Acc|Gender=Neut|Number=Sing|Polarity=Pos|VerbForm=Vnoun
prep:loc:wok	AdpType=Prep|Variant=Long
subst:pl:gen:n:pt	Case=Gen|Gender=Neut|Number=Ptan
praet:sg:m2:imperf	Animacy=Nhum|Aspect=Imp|Gender=Masc|Mood=Ind|Number=Sing|Tense=Past|VerbForm=Fin|Voice=Act
brev:npun	Abbr=Yes|Pun=No
num:pl:acc:f:congr	Case=Acc|Gender=Fem|Number=Plur|NumForm=Word
praet:sg:m1:imperf:nagl	Animacy=Hum|Aspect=Imp|Gender=Masc|Mood=Ind|Number=Sing|Tense=Past|VerbForm=Fin|Voice=Act
ppron3:sg:dat:f:ter:akc:npraep	Case=Dat|Gender=Fem|Number=Sing|Person=3|PrepCase=Npr|PronType=Prs|Variant=Long
num:pl:acc:m1:rec	Animacy=Hum|Case=Acc|Gender=Masc|Number=Plur|NumForm=Word
num:pl:acc:n:rec:ncol	Case=Acc|Gender=Neut|Number=Plur|NumType=Card|PronType=Ind
ppron3:pl:acc:n:ter:akc:praep	Case=Acc|Gender=Neut|Number=Plur|Person=3|PrepCase=Pre|PronType=Prs|Variant=Long
num:pl:acc:m2:congr	Animacy=Nhum|Case=Acc|Gender=Masc|Number=Plur|NumForm=Word
subst:pl:acc:m2	Animacy=Nhum|Case=Acc|Gender=Masc|Number=Plur
pact:pl:acc:m1:imperf:aff	Animacy=Hum|Aspect=Imp|Case=Acc|Gender=Masc|Number=Plur|Polarity=Pos|VerbForm=Part|Voice=Act
ppron3:pl:acc:f:ter:akc:npraep	Case=Acc|Gender=Fem|Number=Plur|Person=3|PrepCase=Npr|PronType=Prs|Variant=Long
subst:sg:dat:m3	Animacy=Inan|Case=Dat|Gender=Masc|Number=Sing
num:pl:loc:m3:congr	Animacy=Inan|Case=Loc|Gender=Masc|Number=Plur|NumForm=Word
ger:pl:nom:n:imperf:aff	Aspect=Imp|Case=Nom|Gender=Neut|Number=Plur|Polarity=Pos|VerbForm=Vnoun
praet:pl:m2:perf	Animacy=Nhum|Aspect=Perf|Gender=Masc|Mood=Ind|Number=Plur|Tense=Past|VerbForm=Fin|Voice=Act
subst:pl:dat:m1	Animacy=Hum|Case=Dat|Gender=Masc|Number=Plur
ppron3:sg:acc:m2:ter:nakc:npraep	Animacy=Nhum|Case=Acc|Gender=Masc|Number=Sing|Person=3|PrepCase=Npr|PronType=Prs|Variant=Short
subst:sg:dat:f	Case=Dat|Gender=Fem|Number=Sing
ger:sg:loc:n:perf:aff	Aspect=Perf|Case=Loc|Gender=Neut|Number=Sing|Polarity=Pos|VerbForm=Vnoun
num:pl:acc:m2:rec	Animacy=Nhum|Case=Acc|Gender=Masc|Number=Plur|NumForm=Digit|NumType=Card
prep:nom	AdpType=Prep
ppron3:sg:dat:m3:ter:nakc:npraep	Animacy=Inan|Case=Dat|Gender=Masc|Number=Sing|Person=3|PrepCase=Npr|PronType=Prs|Variant=Short
ppron3:sg:acc:f:ter:akc:npraep	Case=Acc|Gender=Fem|Number=Sing|Person=3|PrepCase=Npr|PronType=Prs|Variant=Long
praet:pl:m3:imperf	Animacy=Inan|Aspect=Imp|Gender=Masc|Mood=Ind|Number=Plur|Tense=Past|VerbForm=Fin|Voice=Act
pact:sg:gen:m3:imperf:aff	Animacy=Inan|Aspect=Imp|Case=Gen|Gender=Masc|Number=Sing|Polarity=Pos|VerbForm=Part|Voice=Act
ppas:sg:acc:m3:perf:aff	Animacy=Inan|Aspect=Perf|Case=Acc|Gender=Masc|Number=Sing|Polarity=Pos|VerbForm=Part|Voice=Pass
ppron12:sg:dat:m1:pri:nakc	Animacy=Hum|Case=Dat|Gender=Masc|Number=Sing|Person=1|PronType=Prs|Variant=Short
ppron12:sg:dat:f:sec:nakc	Case=Dat|Gender=Fem|Number=Sing|Person=2|PronType=Prs|Variant=Short
ppron12:sg:acc:m1:sec:akc	Animacy=Hum|Case=Acc|Gender=Masc|Number=Sing|Person=2|PronType=Prs|Variant=Long
ppron12:sg:acc:m1:pri:akc	Animacy=Hum|Case=Acc|Gender=Masc|Number=Sing|Person=1|PronType=Prs|Variant=Long
ger:sg:loc:n:imperf:aff	Aspect=Imp|Case=Loc|Gender=Neut|Number=Sing|Polarity=Pos|VerbForm=Vnoun
fin:pl:ter:perf	Aspect=Perf|Mood=Ind|Number=Plur|Person=3|Tense=Fut|VerbForm=Fin|Voice=Act
adj:sg:acc:m2:pos	Animacy=Nhum|Case=Acc|Degree=Pos|Gender=Masc|Number=Sing
ppron3:sg:nom:m1:ter:akc:npraep	Animacy=Hum|Case=Nom|Gender=Masc|Number=Sing|Person=3|PrepCase=Npr|PronType=Prs|Variant=Long
subst:pl:acc:n:col	Case=Acc|Gender=Neut|Number=Plur|NumType=Sets
ppas:sg:gen:m2:perf:aff	Animacy=Nhum|Aspect=Perf|Case=Gen|Gender=Masc|Number=Sing|Polarity=Pos|VerbForm=Part|Voice=Pass
subst:sg:voc:m1	Animacy=Hum|Case=Voc|Gender=Masc|Number=Sing
winien:sg:m1:imperf	Animacy=Hum|Aspect=Imp|Gender=Masc|Mood=Ind|Number=Sing|Tense=Pres|VerbForm=Fin|VerbType=Mod|Voice=Act
ppron12:sg:acc:f:pri:akc	Case=Acc|Gender=Fem|Number=Sing|Person=1|PronType=Prs|Variant=Long
ppron12:sg:dat:f:pri:nakc	Case=Dat|Gender=Fem|Number=Sing|Person=1|PronType=Prs|Variant=Short
aglt:sg:sec:imperf:nwok	Aspect=Imp|Clitic=Yes|Number=Sing|Person=2|Variant=Short
subst:sg:voc:f	Case=Voc|Gender=Fem|Number=Sing
impt:pl:pri:imperf	Aspect=Imp|Mood=Imp|Number=Plur|Person=1|VerbForm=Fin|Voice=Act
adj:sg:loc:m1:pos	Animacy=Hum|Case=Loc|Degree=Pos|Gender=Masc|Number=Sing
subst:sg:loc:m1	Animacy=Hum|Case=Loc|Gender=Masc|Number=Sing
ppron12:sg:loc:m1:pri	Animacy=Hum|Case=Loc|Gender=Masc|Number=Sing|Person=1|PronType=Prs
adj:sg:acc:m3:com	Animacy=Inan|Case=Acc|Degree=Cmp|Gender=Masc|Number=Sing
ppron3:sg:gen:m1:ter:nakc:npraep	Animacy=Hum|Case=Gen|Gender=Masc|Number=Sing|Person=3|PrepCase=Npr|PronType=Prs|Variant=Short
impt:sg:sec:perf	Aspect=Perf|Mood=Imp|Number=Sing|Person=2|VerbForm=Fin|Voice=Act
praet:pl:f:imperf	Aspect=Imp|Gender=Fem|Mood=Ind|Number=Plur|Tense=Past|VerbForm=Fin|Voice=Act
ppron3:sg:dat:m1:ter:akc:praep	Animacy=Hum|Case=Dat|Gender=Masc|Number=Sing|Person=3|PrepCase=Pre|PronType=Prs|Variant=Long
praet:sg:m1:perf:nagl	Animacy=Hum|Aspect=Perf|Gender=Masc|Mood=Ind|Number=Sing|Tense=Past|VerbForm=Fin|Voice=Act
bedzie:sg:pri:imperf	Aspect=Imp|Mood=Ind|Number=Sing|Person=1|Tense=Fut|VerbForm=Fin
ppron3:sg:acc:m1:ter:nakc:npraep	Animacy=Hum|Case=Acc|Gender=Masc|Number=Sing|Person=3|PrepCase=Npr|PronType=Prs|Variant=Short
impt:pl:sec:perf	Aspect=Perf|Mood=Imp|Number=Plur|Person=2|VerbForm=Fin|Voice=Act
fin:pl:sec:perf	Aspect=Perf|Mood=Ind|Number=Plur|Person=2|Tense=Fut|VerbForm=Fin|Voice=Act
ppron12:pl:inst:m1:pri	Animacy=Hum|Case=Ins|Gender=Masc|Number=Plur|Person=1|PronType=Prs
ppron12:pl:dat:m1:sec	Animacy=Hum|Case=Dat|Gender=Masc|Number=Plur|Person=2|PronType=Prs
adj:pl:nom:m2:pos	Animacy=Nhum|Case=Nom|Degree=Pos|Gender=Masc|Number=Plur
praet:pl:n:imperf	Aspect=Imp|Gender=Neut|Mood=Ind|Number=Plur|Tense=Past|VerbForm=Fin|Voice=Act
ppron3:sg:loc:m1:ter:akc:praep	Animacy=Hum|Case=Loc|Gender=Masc|Number=Sing|Person=3|PrepCase=Pre|PronType=Prs|Variant=Long
ppron3:sg:inst:f:ter:akc:praep	Case=Ins|Gender=Fem|Number=Sing|Person=3|PrepCase=Pre|PronType=Prs|Variant=Long
ppron3:pl:nom:m1:ter:akc:npraep	Animacy=Hum|Case=Nom|Gender=Masc|Number=Plur|Person=3|PrepCase=Npr|PronType=Prs|Variant=Long
praet:sg:m2:perf	Animacy=Nhum|Aspect=Perf|Gender=Masc|Mood=Ind|Number=Sing|Tense=Past|VerbForm=Fin|Voice=Act
ger:sg:gen:n:imperf:aff	Aspect=Imp|Case=Gen|Gender=Neut|Number=Sing|Polarity=Pos|VerbForm=Vnoun
ppron3:sg:acc:f:ter:akc:praep	Case=Acc|Gender=Fem|Number=Sing|Person=3|PrepCase=Pre|PronType=Prs|Variant=Long
adj:pl:inst:m1:pos	Animacy=Hum|Case=Ins|Degree=Pos|Gender=Masc|Number=Plur
num:pl:acc:n:congr:ncol	Case=Acc|Gender=Neut|Number=Plur|NumForm=Word
bedzie:pl:pri:imperf	Aspect=Imp|Mood=Ind|Number=Plur|Person=1|Tense=Fut|VerbForm=Fin
impt:pl:sec:imperf	Aspect=Imp|Mood=Imp|Number=Plur|Person=2|VerbForm=Fin|Voice=Act
subst:pl:voc:n:pt	Case=Voc|Gender=Neut|Number=Ptan
adj:sg:loc:m2:pos	Animacy=Nhum|Case=Loc|Degree=Pos|Gender=Masc|Number=Sing
ppron3:pl:acc:f:ter:akc:praep	Case=Acc|Gender=Fem|Number=Plur|Person=3|PrepCase=Pre|PronType=Prs|Variant=Long
ppron3:sg:nom:n:ter:akc:npraep	Case=Nom|Gender=Neut|Number=Sing|Person=3|PrepCase=Npr|PronType=Prs|Variant=Long
praet:pl:m3:perf	Animacy=Inan|Aspect=Perf|Gender=Masc|Mood=Ind|Number=Plur|Tense=Past|VerbForm=Fin|Voice=Act
ger:sg:gen:n:perf:aff	Aspect=Perf|Case=Gen|Gender=Neut|Number=Sing|Polarity=Pos|VerbForm=Vnoun
bedzie:pl:ter:imperf	Aspect=Imp|Mood=Ind|Number=Plur|Person=3|Tense=Fut|VerbForm=Fin
ppron12:sg:nom:m1:sec	Animacy=Hum|Case=Nom|Gender=Masc|Number=Sing|Person=2|PronType=Prs
winien:pl:f:imperf	Aspect=Imp|Gender=Fem|Mood=Ind|Number=Plur|Tense=Pres|VerbForm=Fin|VerbType=Mod|Voice=Act
ppas:pl:nom:f:perf:aff	Aspect=Perf|Case=Nom|Gender=Fem|Number=Plur|Polarity=Pos|VerbForm=Part|Voice=Pass
subst:pl:nom:n:ncol	Case=Nom|Gender=Neut|Number=Plur
pact:sg:acc:m3:imperf:aff	Animacy=Inan|Aspect=Imp|Case=Acc|Gender=Masc|Number=Sing|Polarity=Pos|VerbForm=Part|Voice=Act
ppron3:pl:acc:m3:ter:akc:npraep	Animacy=Inan|Case=Acc|Gender=Masc|Number=Plur|Person=3|PrepCase=Npr|PronType=Prs|Variant=Long
ppron3:sg:loc:m3:ter:akc:praep	Animacy=Inan|Case=Loc|Gender=Masc|Number=Sing|Person=3|PrepCase=Pre|PronType=Prs|Variant=Long
ppas:pl:acc:m2:perf:aff	Animacy=Nhum|Aspect=Perf|Case=Acc|Gender=Masc|Number=Plur|Polarity=Pos|VerbForm=Part|Voice=Pass
ppas:sg:nom:n:perf:aff	Aspect=Perf|Case=Nom|Gender=Neut|Number=Sing|Polarity=Pos|VerbForm=Part|Voice=Pass
adj:sg:dat:f:pos	Case=Dat|Degree=Pos|Gender=Fem|Number=Sing
adj:sg:acc:m3:sup	Animacy=Inan|Case=Acc|Degree=Sup|Gender=Masc|Number=Sing
ppas:pl:nom:n:perf:aff	Aspect=Perf|Case=Nom|Gender=Neut|Number=Plur|Polarity=Pos|VerbForm=Part|Voice=Pass
ppron3:sg:acc:m3:ter:nakc:npraep	Animacy=Inan|Case=Acc|Gender=Masc|Number=Sing|Person=3|PrepCase=Npr|PronType=Prs|Variant=Short
brev:pun	Abbr=Yes|Pun=Yes
ppas:pl:nom:m3:perf:aff	Animacy=Inan|Aspect=Perf|Case=Nom|Gender=Masc|Number=Plur|Polarity=Pos|VerbForm=Part|Voice=Pass
ppron12:pl:gen:m1:pri	Animacy=Hum|Case=Gen|Gender=Masc|Number=Plur|Person=1|PronType=Prs
ppron12:pl:nom:m1:pri	Animacy=Hum|Case=Nom|Gender=Masc|Number=Plur|Person=1|PronType=Prs
num:pl:inst:f:congr	Case=Ins|Gender=Fem|Number=Plur|NumForm=Word
frag	Foreign=Yes
ppas:pl:nom:f:imperf:aff	Aspect=Imp|Case=Nom|Gender=Fem|Number=Plur|Polarity=Pos|VerbForm=Part|Voice=Pass
ppas:pl:acc:m3:perf:aff	Animacy=Inan|Aspect=Perf|Case=Acc|Gender=Masc|Number=Plur|Polarity=Pos|VerbForm=Part|Voice=Pass
siebie:loc	Case=Loc|PronType=Prs|Reflex=Yes
adj:sg:nom:m3:com	Animacy=Inan|Case=Nom|Degree=Cmp|Gender=Masc|Number=Sing
num:sg:gen:m3:rec	Animacy=Inan|Case=Gen|Gender=Masc|Number=Sing|NumForm=Word
pact:sg:nom:m2:imperf:aff	Animacy=Nhum|Aspect=Imp|Case=Nom|Gender=Masc|Number=Sing|Polarity=Pos|VerbForm=Part|Voice=Act
ppas:pl:gen:m1:imperf:aff	Animacy=Hum|Aspect=Imp|Case=Gen|Gender=Masc|Number=Plur|Polarity=Pos|VerbForm=Part|Voice=Pass
ppas:pl:gen:f:perf:neg	Aspect=Perf|Case=Gen|Gender=Fem|Number=Plur|Polarity=Neg|VerbForm=Part|Voice=Pass
subst:pl:dat:m3	Animacy=Inan|Case=Dat|Gender=Masc|Number=Plur
ger:pl:gen:n:perf:aff	Aspect=Perf|Case=Gen|Gender=Neut|Number=Plur|Polarity=Pos|VerbForm=Vnoun
ppas:sg:gen:m1:perf:aff	Animacy=Hum|Aspect=Perf|Case=Gen|Gender=Masc|Number=Sing|Polarity=Pos|VerbForm=Part|Voice=Pass
ppas:pl:acc:m1:perf:aff	Animacy=Hum|Aspect=Perf|Case=Acc|Gender=Masc|Number=Plur|Polarity=Pos|VerbForm=Part|Voice=Pass
adj:pl:inst:m1:sup	Animacy=Hum|Case=Ins|Degree=Sup|Gender=Masc|Number=Plur
winien:sg:f:imperf	Aspect=Imp|Gender=Fem|Mood=Ind|Number=Sing|Tense=Pres|VerbForm=Fin|VerbType=Mod|Voice=Act
pact:pl:gen:m1:imperf:aff	Animacy=Hum|Aspect=Imp|Case=Gen|Gender=Masc|Number=Plur|Polarity=Pos|VerbForm=Part|Voice=Act
subst:pl:dat:f	Case=Dat|Gender=Fem|Number=Plur
adj:pl:dat:f:pos	Case=Dat|Degree=Pos|Gender=Fem|Number=Plur
adj:pl:nom:f:sup	Case=Nom|Degree=Sup|Gender=Fem|Number=Plur
adj:pl:dat:n:pos	Case=Dat|Degree=Pos|Gender=Neut|Number=Plur
subst:pl:dat:n:ncol	Case=Dat|Gender=Neut|Number=Plur
adj:sg:loc:n:sup	Case=Loc|Degree=Sup|Gender=Neut|Number=Sing
pact:sg:inst:f:imperf:aff	Aspect=Imp|Case=Ins|Gender=Fem|Number=Sing|Polarity=Pos|VerbForm=Part|Voice=Act
pant:perf	Aspect=Perf|Tense=Past|VerbForm=Conv|Voice=Act
pact:pl:nom:m3:imperf:aff	Animacy=Inan|Aspect=Imp|Case=Nom|Gender=Masc|Number=Plur|Polarity=Pos|VerbForm=Part|Voice=Act
subst:pl:loc:n:col	Case=Loc|Gender=Neut|Number=Plur|NumType=Sets
ger:sg:gen:n:perf:neg	Aspect=Perf|Case=Gen|Gender=Neut|Number=Sing|Polarity=Neg|VerbForm=Vnoun
num:pl:nom:m3:rec	Animacy=Inan|Case=Nom|Gender=Masc|Number=Plur|NumForm=Digit|NumType=Card
adj:sg:nom:m1:sup	Animacy=Hum|Case=Nom|Degree=Sup|Gender=Masc|Number=Sing
ppas:sg:gen:m1:imperf:aff	Animacy=Hum|Aspect=Imp|Case=Gen|Gender=Masc|Number=Sing|Polarity=Pos|VerbForm=Part|Voice=Pass
dig	NumForm=Digit
praet:sg:m3:imperf:nagl	Animacy=Inan|Aspect=Imp|Gender=Masc|Mood=Ind|Number=Sing|Tense=Past|VerbForm=Fin|Voice=Act
ppron3:sg:dat:m1:ter:akc:npraep	Animacy=Hum|Case=Dat|Gender=Masc|Number=Sing|Person=3|PrepCase=Npr|PronType=Prs|Variant=Long
ger:sg:nom:n:imperf:aff	Aspect=Imp|Case=Nom|Gender=Neut|Number=Sing|Polarity=Pos|VerbForm=Vnoun
ppas:sg:acc:n:perf:aff	Aspect=Perf|Case=Acc|Gender=Neut|Number=Sing|Polarity=Pos|VerbForm=Part|Voice=Pass
ppron3:pl:gen:m3:ter:akc:npraep	Animacy=Inan|Case=Gen|Gender=Masc|Number=Plur|Person=3|PrepCase=Npr|PronType=Prs|Variant=Long
ppas:sg:gen:f:imperf:aff	Aspect=Imp|Case=Gen|Gender=Fem|Number=Sing|Polarity=Pos|VerbForm=Part|Voice=Pass
subst:pl:inst:m2	Animacy=Nhum|Case=Ins|Gender=Masc|Number=Plur
ppas:pl:nom:m3:imperf:aff	Animacy=Inan|Aspect=Imp|Case=Nom|Gender=Masc|Number=Plur|Polarity=Pos|VerbForm=Part|Voice=Pass
num:pl:gen:m3:congr	Animacy=Inan|Case=Gen|Gender=Masc|Number=Plur|NumForm=Digit|NumType=Card
ppas:pl:nom:n:imperf:aff	Aspect=Imp|Case=Nom|Gender=Neut|Number=Plur|Polarity=Pos|VerbForm=Part|Voice=Pass
ger:sg:nom:n:perf:aff	Aspect=Perf|Case=Nom|Gender=Neut|Number=Sing|Polarity=Pos|VerbForm=Vnoun
ppas:pl:nom:m1:perf:aff	Animacy=Hum|Aspect=Perf|Case=Nom|Gender=Masc|Number=Plur|Polarity=Pos|VerbForm=Part|Voice=Pass
ppas:sg:nom:m2:imperf:aff	Animacy=Nhum|Aspect=Imp|Case=Nom|Gender=Masc|Number=Sing|Polarity=Pos|VerbForm=Part|Voice=Pass
adj:pl:dat:m1:pos	Animacy=Hum|Case=Dat|Degree=Pos|Gender=Masc|Number=Plur
adj:sg:inst:f:com	Case=Ins|Degree=Cmp|Gender=Fem|Number=Sing
adj:sg:gen:f:com	Case=Gen|Degree=Cmp|Gender=Fem|Number=Sing
num:pl:gen:m1:congr	Animacy=Hum|Case=Gen|Gender=Masc|Number=Plur|NumForm=Word
winien:pl:n:imperf	Aspect=Imp|Gender=Neut|Mood=Ind|Number=Plur|Tense=Pres|VerbForm=Fin|VerbType=Mod|Voice=Act
pact:sg:acc:m1:imperf:aff	Animacy=Hum|Aspect=Imp|Case=Acc|Gender=Masc|Number=Sing|Polarity=Pos|VerbForm=Part|Voice=Act
ppas:pl:gen:m3:perf:aff	Animacy=Inan|Aspect=Perf|Case=Gen|Gender=Masc|Number=Plur|Polarity=Pos|VerbForm=Part|Voice=Pass
ppas:sg:inst:f:imperf:aff	Aspect=Imp|Case=Ins|Gender=Fem|Number=Sing|Polarity=Pos|VerbForm=Part|Voice=Pass
pact:pl:acc:f:imperf:aff	Aspect=Imp|Case=Acc|Gender=Fem|Number=Plur|Polarity=Pos|VerbForm=Part|Voice=Act
ppas:sg:acc:f:imperf:aff	Aspect=Imp|Case=Acc|Gender=Fem|Number=Sing|Polarity=Pos|VerbForm=Part|Voice=Pass
ppron3:pl:acc:m1:ter:akc:npraep	Animacy=Hum|Case=Acc|Gender=Masc|Number=Plur|Person=3|PrepCase=Npr|PronType=Prs|Variant=Long
ppas:pl:gen:m3:imperf:aff	Animacy=Inan|Aspect=Imp|Case=Gen|Gender=Masc|Number=Plur|Polarity=Pos|VerbForm=Part|Voice=Pass
num:pl:nom:m2:rec	Animacy=Nhum|Case=Nom|Gender=Masc|Number=Plur|NumForm=Digit|NumType=Card
ppron3:sg:nom:f:ter:akc:npraep	Case=Nom|Gender=Fem|Number=Sing|Person=3|PrepCase=Npr|PronType=Prs|Variant=Long
ppron3:pl:dat:m3:ter:akc:npraep	Animacy=Inan|Case=Dat|Gender=Masc|Number=Plur|Person=3|PrepCase=Npr|PronType=Prs|Variant=Long
adj:pl:dat:m3:pos	Animacy=Inan|Case=Dat|Degree=Pos|Gender=Masc|Number=Plur
ppron3:pl:dat:m1:ter:akc:npraep	Animacy=Hum|Case=Dat|Gender=Masc|Number=Plur|Person=3|PrepCase=Npr|PronType=Prs|Variant=Long
ppron3:pl:loc:n:ter:akc:praep	Case=Loc|Gender=Neut|Number=Plur|Person=3|PrepCase=Pre|PronType=Prs|Variant=Long
interj	_
ppron3:sg:dat:f:ter:akc:praep	Case=Dat|Gender=Fem|Number=Sing|Person=3|PrepCase=Pre|PronType=Prs|Variant=Long
bedzie:pl:sec:imperf	Aspect=Imp|Mood=Ind|Number=Plur|Person=2|Tense=Fut|VerbForm=Fin
num:sg:acc:m3:rec	Animacy=Inan|Case=Acc|Gender=Masc|Number=Sing|NumForm=Word
ppron3:pl:gen:f:ter:akc:npraep	Case=Gen|Gender=Fem|Number=Plur|Person=3|PrepCase=Npr|PronType=Prs|Variant=Long
ger:sg:inst:n:imperf:aff	Aspect=Imp|Case=Ins|Gender=Neut|Number=Sing|Polarity=Pos|VerbForm=Vnoun
ppas:sg:nom:n:imperf:aff	Aspect=Imp|Case=Nom|Gender=Neut|Number=Sing|Polarity=Pos|VerbForm=Part|Voice=Pass
ppas:pl:gen:f:imperf:aff	Aspect=Imp|Case=Gen|Gender=Fem|Number=Plur|Polarity=Pos|VerbForm=Part|Voice=Pass
ppron3:pl:gen:m3:ter:akc:praep	Animacy=Inan|Case=Gen|Gender=Masc|Number=Plur|Person=3|PrepCase=Pre|PronType=Prs|Variant=Long
adj:pl:loc:m3:com	Animacy=Inan|Case=Loc|Degree=Cmp|Gender=Masc|Number=Plur
winien:sg:m3:imperf	Animacy=Inan|Aspect=Imp|Gender=Masc|Mood=Ind|Number=Sing|Tense=Pres|VerbForm=Fin|VerbType=Mod|Voice=Act
winien:pl:m1:imperf	Animacy=Hum|Aspect=Imp|Gender=Masc|Mood=Ind|Number=Plur|Tense=Pres|VerbForm=Fin|VerbType=Mod|Voice=Act
adj:pl:acc:m2:pos	Animacy=Nhum|Case=Acc|Degree=Pos|Gender=Masc|Number=Plur
ppron3:sg:gen:m3:ter:akc:npraep	Animacy=Inan|Case=Gen|Gender=Masc|Number=Sing|Person=3|PrepCase=Npr|PronType=Prs|Variant=Long
pact:sg:dat:m3:imperf:aff	Animacy=Inan|Aspect=Imp|Case=Dat|Gender=Masc|Number=Sing|Polarity=Pos|VerbForm=Part|Voice=Act
adj:sg:dat:m3:pos	Animacy=Inan|Case=Dat|Degree=Pos|Gender=Masc|Number=Sing
adj:sg:dat:f:sup	Case=Dat|Degree=Sup|Gender=Fem|Number=Sing
ppron12:pl:gen:m1:sec	Animacy=Hum|Case=Gen|Gender=Masc|Number=Plur|Person=2|PronType=Prs
adj:pl:gen:m3:sup	Animacy=Inan|Case=Gen|Degree=Sup|Gender=Masc|Number=Plur
ppron3:pl:inst:m3:ter:akc:npraep	Animacy=Inan|Case=Ins|Gender=Masc|Number=Plur|Person=3|PrepCase=Npr|PronType=Prs|Variant=Long
adj:pl:gen:n:com	Case=Gen|Degree=Cmp|Gender=Neut|Number=Plur
adj:sg:inst:m3:sup	Animacy=Inan|Case=Ins|Degree=Sup|Gender=Masc|Number=Sing
ppron3:sg:inst:n:ter:akc:npraep	Case=Ins|Gender=Neut|Number=Sing|Person=3|PrepCase=Npr|PronType=Prs|Variant=Long
ppas:sg:dat:f:perf:aff	Aspect=Perf|Case=Dat|Gender=Fem|Number=Sing|Polarity=Pos|VerbForm=Part|Voice=Pass
ppron12:sg:acc:f:sec:nakc	Case=Acc|Gender=Fem|Number=Sing|Person=2|PronType=Prs|Variant=Short
ppas:pl:loc:m3:perf:aff	Animacy=Inan|Aspect=Perf|Case=Loc|Gender=Masc|Number=Plur|Polarity=Pos|VerbForm=Part|Voice=Pass
ppas:pl:acc:n:perf:aff	Aspect=Perf|Case=Acc|Gender=Neut|Number=Plur|Polarity=Pos|VerbForm=Part|Voice=Pass
subst:pl:nom:n:col	Case=Nom|Gender=Neut|Number=Plur|NumType=Sets
ger:pl:acc:n:imperf:aff	Aspect=Imp|Case=Acc|Gender=Neut|Number=Plur|Polarity=Pos|VerbForm=Vnoun
ppron3:pl:loc:f:ter:akc:praep	Case=Loc|Gender=Fem|Number=Plur|Person=3|PrepCase=Pre|PronType=Prs|Variant=Long
adj:sg:acc:n:com	Case=Acc|Degree=Cmp|Gender=Neut|Number=Sing
ppron3:pl:nom:f:ter:akc:npraep	Case=Nom|Gender=Fem|Number=Plur|Person=3|PrepCase=Npr|PronType=Prs|Variant=Long
winien:sg:n:imperf	Aspect=Imp|Gender=Neut|Mood=Ind|Number=Sing|Tense=Pres|VerbForm=Fin|VerbType=Mod|Voice=Act
ger:sg:inst:n:perf:aff	Aspect=Perf|Case=Ins|Gender=Neut|Number=Sing|Polarity=Pos|VerbForm=Vnoun
ppron12:pl:dat:m1:pri	Animacy=Hum|Case=Dat|Gender=Masc|Number=Plur|Person=1|PronType=Prs
adj:sg:nom:n:sup	Case=Nom|Degree=Sup|Gender=Neut|Number=Sing
adj:sg:dat:n:pos	Case=Dat|Degree=Pos|Gender=Neut|Number=Sing
subst:sg:dat:n:ncol	Case=Dat|Gender=Neut|Number=Sing
ppas:sg:nom:m3:imperf:aff	Animacy=Inan|Aspect=Imp|Case=Nom|Gender=Masc|Number=Sing|Polarity=Pos|VerbForm=Part|Voice=Pass
pact:pl:acc:m3:imperf:aff	Animacy=Inan|Aspect=Imp|Case=Acc|Gender=Masc|Number=Plur|Polarity=Pos|VerbForm=Part|Voice=Act
adj:sg:inst:m1:sup	Animacy=Hum|Case=Ins|Degree=Sup|Gender=Masc|Number=Sing
pact:sg:nom:m3:imperf:aff	Animacy=Inan|Aspect=Imp|Case=Nom|Gender=Masc|Number=Sing|Polarity=Pos|VerbForm=Part|Voice=Act
pact:sg:gen:n:imperf:aff	Aspect=Imp|Case=Gen|Gender=Neut|Number=Sing|Polarity=Pos|VerbForm=Part|Voice=Act
ppron3:pl:loc:m3:ter:akc:praep	Animacy=Inan|Case=Loc|Gender=Masc|Number=Plur|Person=3|PrepCase=Pre|PronType=Prs|Variant=Long
subst:sg:gen:n:col	Case=Gen|Gender=Neut|Number=Sing|NumType=Sets
aglt:sg:sec:imperf:wok	Aspect=Imp|Clitic=Yes|Number=Sing|Person=2|Variant=Long
ppron12:sg:gen:m1:pri:akc	Animacy=Hum|Case=Gen|Gender=Masc|Number=Sing|Person=1|PronType=Prs|Variant=Long
adj:sg:gen:f:sup	Case=Gen|Degree=Sup|Gender=Fem|Number=Sing
ppas:sg:gen:n:perf:aff	Aspect=Perf|Case=Gen|Gender=Neut|Number=Sing|Polarity=Pos|VerbForm=Part|Voice=Pass
prep:acc:wok	AdpType=Prep|Variant=Long
adj:pl:acc:n:com	Case=Acc|Degree=Cmp|Gender=Neut|Number=Plur
ppron3:pl:inst:m1:ter:akc:praep	Animacy=Hum|Case=Ins|Gender=Masc|Number=Plur|Person=3|PrepCase=Pre|PronType=Prs|Variant=Long
ppron3:pl:dat:m1:ter:nakc:npraep	Animacy=Hum|Case=Dat|Gender=Masc|Number=Plur|Person=3|PrepCase=Npr|PronType=Prs|Variant=Short
ppron3:sg:gen:m3:ter:akc:praep	Animacy=Inan|Case=Gen|Gender=Masc|Number=Sing|Person=3|PrepCase=Pre|PronType=Prs|Variant=Long
pact:pl:loc:n:imperf:aff	Aspect=Imp|Case=Loc|Gender=Neut|Number=Plur|Polarity=Pos|VerbForm=Part|Voice=Act
ppron12:sg:inst:m1:sec	Animacy=Hum|Case=Ins|Gender=Masc|Number=Sing|Person=2|PronType=Prs
adj:pl:nom:m3:com	Animacy=Inan|Case=Nom|Degree=Cmp|Gender=Masc|Number=Plur
subst:pl:dat:n:col	Case=Dat|Gender=Neut|Number=Plur|NumType=Sets
ppron12:sg:dat:m1:sec:akc	Animacy=Hum|Case=Dat|Gender=Masc|Number=Sing|Person=2|PronType=Prs|Variant=Long
praet:sg:m1:imperf:agl	Animacy=Hum|Aspect=Imp|Gender=Masc|Mood=Ind|Number=Sing|Tense=Past|VerbForm=Fin|Voice=Act
pact:pl:dat:f:imperf:aff	Aspect=Imp|Case=Dat|Gender=Fem|Number=Plur|Polarity=Pos|VerbForm=Part|Voice=Act
num:pl:gen:m2:congr	Animacy=Nhum|Case=Gen|Gender=Masc|Number=Plur|NumForm=Digit|NumType=Card
ppas:sg:nom:f:perf:neg	Aspect=Perf|Case=Nom|Gender=Fem|Number=Sing|Polarity=Neg|VerbForm=Part|Voice=Pass
praet:pl:m2:imperf	Animacy=Nhum|Aspect=Imp|Gender=Masc|Mood=Ind|Number=Plur|Tense=Past|VerbForm=Fin|Voice=Act
ppas:sg:gen:m3:imperf:aff	Animacy=Inan|Aspect=Imp|Case=Gen|Gender=Masc|Number=Sing|Polarity=Pos|VerbForm=Part|Voice=Pass
adj:sg:loc:m3:com	Animacy=Inan|Case=Loc|Degree=Cmp|Gender=Masc|Number=Sing
ger:pl:loc:n:imperf:aff	Aspect=Imp|Case=Loc|Gender=Neut|Number=Plur|Polarity=Pos|VerbForm=Vnoun
ppas:sg:acc:m1:perf:aff	Animacy=Hum|Aspect=Perf|Case=Acc|Gender=Masc|Number=Sing|Polarity=Pos|VerbForm=Part|Voice=Pass
ppron12:sg:dat:m1:sec:nakc	Animacy=Hum|Case=Dat|Gender=Masc|Number=Sing|Person=2|PronType=Prs|Variant=Short
adj:pl:gen:f:sup	Case=Gen|Degree=Sup|Gender=Fem|Number=Plur
adj:sg:loc:m3:sup	Animacy=Inan|Case=Loc|Degree=Sup|Gender=Masc|Number=Sing
adj:sg:dat:m1:pos	Animacy=Hum|Case=Dat|Degree=Pos|Gender=Masc|Number=Sing
adj:sg:gen:n:com	Case=Gen|Degree=Cmp|Gender=Neut|Number=Sing
pact:pl:gen:m3:imperf:aff	Animacy=Inan|Aspect=Imp|Case=Gen|Gender=Masc|Number=Plur|Polarity=Pos|VerbForm=Part|Voice=Act
ppron3:sg:inst:m2:ter:akc:praep	Animacy=Nhum|Case=Ins|Gender=Masc|Number=Sing|Person=3|PrepCase=Pre|PronType=Prs|Variant=Long
ppron3:pl:nom:m3:ter:akc:npraep	Animacy=Inan|Case=Nom|Gender=Masc|Number=Plur|Person=3|PrepCase=Npr|PronType=Prs|Variant=Long
adj:sg:acc:f:sup	Case=Acc|Degree=Sup|Gender=Fem|Number=Sing
adj:sg:nom:m3:sup	Animacy=Inan|Case=Nom|Degree=Sup|Gender=Masc|Number=Sing
winien:pl:m3:imperf	Animacy=Inan|Aspect=Imp|Gender=Masc|Mood=Ind|Number=Plur|Tense=Pres|VerbForm=Fin|VerbType=Mod|Voice=Act
ppas:pl:acc:f:perf:aff	Aspect=Perf|Case=Acc|Gender=Fem|Number=Plur|Polarity=Pos|VerbForm=Part|Voice=Pass
pact:pl:nom:m1:imperf:aff	Animacy=Hum|Aspect=Imp|Case=Nom|Gender=Masc|Number=Plur|Polarity=Pos|VerbForm=Part|Voice=Act
pact:sg:loc:f:imperf:aff	Aspect=Imp|Case=Loc|Gender=Fem|Number=Sing|Polarity=Pos|VerbForm=Part|Voice=Act
adj:pl:nom:n:com	Case=Nom|Degree=Cmp|Gender=Neut|Number=Plur
adj:sg:gen:m3:com	Animacy=Inan|Case=Gen|Degree=Cmp|Gender=Masc|Number=Sing
ger:sg:dat:n:imperf:aff	Aspect=Imp|Case=Dat|Gender=Neut|Number=Sing|Polarity=Pos|VerbForm=Vnoun
adj:pl:voc:m1:pos	Animacy=Hum|Case=Voc|Degree=Pos|Gender=Masc|Number=Plur
subst:pl:voc:m1	Animacy=Hum|Case=Voc|Gender=Masc|Number=Plur
subst:pl:acc:m1:pt	Animacy=Hum|Case=Acc|Gender=Masc|Number=Ptan
adj:pl:gen:m3:com	Animacy=Inan|Case=Gen|Degree=Cmp|Gender=Masc|Number=Plur
adj:pl:gen:m1:sup	Animacy=Hum|Case=Gen|Degree=Sup|Gender=Masc|Number=Plur
adj:pl:loc:m1:sup	Animacy=Hum|Case=Loc|Degree=Sup|Gender=Masc|Number=Plur
subst:pl:loc:m1	Animacy=Hum|Case=Loc|Gender=Masc|Number=Plur
adj:sg:acc:n:sup	Case=Acc|Degree=Sup|Gender=Neut|Number=Sing
pact:sg:inst:m1:imperf:neg	Animacy=Hum|Aspect=Imp|Case=Ins|Gender=Masc|Number=Sing|Polarity=Neg|VerbForm=Part|Voice=Act
pact:sg:inst:m1:imperf:aff	Animacy=Hum|Aspect=Imp|Case=Ins|Gender=Masc|Number=Sing|Polarity=Pos|VerbForm=Part|Voice=Act
pact:pl:dat:m1:imperf:aff	Animacy=Hum|Aspect=Imp|Case=Dat|Gender=Masc|Number=Plur|Polarity=Pos|VerbForm=Part|Voice=Act
adj:sg:acc:f:com	Case=Acc|Degree=Cmp|Gender=Fem|Number=Sing
ppron12:pl:nom:m1:sec	Animacy=Hum|Case=Nom|Gender=Masc|Number=Plur|Person=2|PronType=Prs
ppron12:sg:inst:m1:pri	Animacy=Hum|Case=Ins|Gender=Masc|Number=Sing|Person=1|PronType=Prs
ppron3:sg:gen:n:ter:akc:npraep	Case=Gen|Gender=Neut|Number=Sing|Person=3|PrepCase=Npr|PronType=Prs|Variant=Long
subst:pl:gen:m1:pt	Animacy=Hum|Case=Gen|Gender=Masc|Number=Ptan
ppas:pl:nom:m1:imperf:aff	Animacy=Hum|Aspect=Imp|Case=Nom|Gender=Masc|Number=Plur|Polarity=Pos|VerbForm=Part|Voice=Pass
num:sg:acc:f:rec	Case=Acc|Gender=Fem|Number=Sing|NumForm=Word
pact:sg:inst:m3:imperf:aff	Animacy=Inan|Aspect=Imp|Case=Ins|Gender=Masc|Number=Sing|Polarity=Pos|VerbForm=Part|Voice=Act
num:pl:gen:n:congr:ncol	Case=Gen|Gender=Neut|Number=Plur|NumForm=Word
ppron3:pl:nom:n:ter:akc:npraep	Case=Nom|Gender=Neut|Number=Plur|Person=3|PrepCase=Npr|PronType=Prs|Variant=Long
ppron12:sg:gen:m1:sec:akc	Animacy=Hum|Case=Gen|Gender=Masc|Number=Sing|Person=2|PronType=Prs|Variant=Long
ppron3:sg:acc:n:ter:akc:praep	Case=Acc|Gender=Neut|Number=Sing|Person=3|PrepCase=Pre|PronType=Prs|Variant=Long
ppas:pl:acc:m3:imperf:aff	Animacy=Inan|Aspect=Imp|Case=Acc|Gender=Masc|Number=Plur|Polarity=Pos|VerbForm=Part|Voice=Pass
ppron12:sg:voc:m2:sec	Animacy=Nhum|Case=Voc|Gender=Masc|Number=Sing|Person=2|PronType=Prs
subst:sg:voc:m2	Animacy=Nhum|Case=Voc|Gender=Masc|Number=Sing
ppron3:sg:inst:m1:ter:akc:npraep	Animacy=Hum|Case=Ins|Gender=Masc|Number=Sing|Person=3|PrepCase=Npr|PronType=Prs|Variant=Long
ppron12:sg:inst:f:sec	Case=Ins|Gender=Fem|Number=Sing|Person=2|PronType=Prs
adj:pl:nom:m1:sup	Animacy=Hum|Case=Nom|Degree=Sup|Gender=Masc|Number=Plur
ppas:sg:inst:m1:imperf:aff	Animacy=Hum|Aspect=Imp|Case=Ins|Gender=Masc|Number=Sing|Polarity=Pos|VerbForm=Part|Voice=Pass
ppron12:sg:nom:f:pri	Case=Nom|Gender=Fem|Number=Sing|Person=1|PronType=Prs
subst:pl:dat:n:pt	Case=Dat|Gender=Neut|Number=Ptan
ppron3:pl:inst:f:ter:akc:praep	Case=Ins|Gender=Fem|Number=Plur|Person=3|PrepCase=Pre|PronType=Prs|Variant=Long
winien:pl:m2:imperf	Animacy=Nhum|Aspect=Imp|Gender=Masc|Mood=Ind|Number=Plur|Tense=Pres|VerbForm=Fin|VerbType=Mod|Voice=Act
adjc	Variant=Short
ger:sg:acc:n:perf:neg	Aspect=Perf|Case=Acc|Gender=Neut|Number=Sing|Polarity=Neg|VerbForm=Vnoun
ppas:sg:dat:m1:imperf:aff	Animacy=Hum|Aspect=Imp|Case=Dat|Gender=Masc|Number=Sing|Polarity=Pos|VerbForm=Part|Voice=Pass
subst:pl:loc:m1:pt	Animacy=Hum|Case=Loc|Gender=Masc|Number=Ptan
depr:pl:nom:m2	Animacy=Nhum|Case=Nom|Gender=Masc|NounForm=Depr|Number=Plur
ppron3:sg:acc:m1:ter:akc:praep	Animacy=Hum|Case=Acc|Gender=Masc|Number=Sing|Person=3|PrepCase=Pre|PronType=Prs|Variant=Long
ppas:sg:inst:n:imperf:aff	Aspect=Imp|Case=Ins|Gender=Neut|Number=Sing|Polarity=Pos|VerbForm=Part|Voice=Pass
ger:sg:acc:n:imperf:neg	Aspect=Imp|Case=Acc|Gender=Neut|Number=Sing|Polarity=Neg|VerbForm=Vnoun
subst:pl:dat:m1:pt	Animacy=Hum|Case=Dat|Gender=Masc|Number=Ptan
pact:sg:inst:n:imperf:aff	Aspect=Imp|Case=Ins|Gender=Neut|Number=Sing|Polarity=Pos|VerbForm=Part|Voice=Act
pact:sg:loc:m3:imperf:aff	Animacy=Inan|Aspect=Imp|Case=Loc|Gender=Masc|Number=Sing|Polarity=Pos|VerbForm=Part|Voice=Act
adj:sg:acc:m2:sup	Animacy=Nhum|Case=Acc|Degree=Sup|Gender=Masc|Number=Sing
ppas:sg:acc:m2:perf:aff	Animacy=Nhum|Aspect=Perf|Case=Acc|Gender=Masc|Number=Sing|Polarity=Pos|VerbForm=Part|Voice=Pass
adj:pl:loc:f:com	Case=Loc|Degree=Cmp|Gender=Fem|Number=Plur
ppron3:pl:acc:n:ter:nakc:praep	Case=Acc|Gender=Neut|Number=Plur|Person=3|PrepCase=Pre|PronType=Prs|Variant=Short
ppron3:pl:acc:m1:ter:akc:praep	Animacy=Hum|Case=Acc|Gender=Masc|Number=Plur|Person=3|PrepCase=Pre|PronType=Prs|Variant=Long
ger:pl:acc:n:perf:aff	Aspect=Perf|Case=Acc|Gender=Neut|Number=Plur|Polarity=Pos|VerbForm=Vnoun
ppron12:sg:inst:f:pri	Case=Ins|Gender=Fem|Number=Sing|Person=1|PronType=Prs
ppron3:pl:loc:m1:ter:akc:praep	Animacy=Hum|Case=Loc|Gender=Masc|Number=Plur|Person=3|PrepCase=Pre|PronType=Prs|Variant=Long
num:pl:gen:m3:rec	Animacy=Inan|Case=Gen|Gender=Masc|Number=Plur|NumForm=Digit|NumType=Card
ppas:pl:nom:m2:perf:aff	Animacy=Nhum|Aspect=Perf|Case=Nom|Gender=Masc|Number=Plur|Polarity=Pos|VerbForm=Part|Voice=Pass
ppas:sg:gen:f:perf:neg	Aspect=Perf|Case=Gen|Gender=Fem|Number=Sing|Polarity=Neg|VerbForm=Part|Voice=Pass
ppron12:pl:acc:n:pri	Case=Acc|Gender=Neut|Number=Plur|Person=1|PronType=Prs
ppron3:sg:acc:n:ter:nakc:npraep	Case=Acc|Gender=Neut|Number=Sing|Person=3|PrepCase=Npr|PronType=Prs|Variant=Short
ppron12:sg:acc:m1:sec:nakc	Animacy=Hum|Case=Acc|Gender=Masc|Number=Sing|Person=2|PronType=Prs|Variant=Short
adj:sg:acc:m1:sup	Animacy=Hum|Case=Acc|Degree=Sup|Gender=Masc|Number=Sing
ger:sg:gen:n:imperf:neg	Aspect=Imp|Case=Gen|Gender=Neut|Number=Sing|Polarity=Neg|VerbForm=Vnoun
ppas:pl:loc:f:imperf:aff	Aspect=Imp|Case=Loc|Gender=Fem|Number=Plur|Polarity=Pos|VerbForm=Part|Voice=Pass
adj:pl:acc:f:com	Case=Acc|Degree=Cmp|Gender=Fem|Number=Plur
num:sg:nom:m3:rec	Animacy=Inan|Case=Nom|Gender=Masc|Number=Sing|NumType=Card|PronType=Ind
adj:sg:gen:n:sup	Case=Gen|Degree=Sup|Gender=Neut|Number=Sing
adj:sg:nom:f:sup	Case=Nom|Degree=Sup|Gender=Fem|Number=Sing
num:sg:loc:f:rec	Case=Loc|Gender=Fem|Number=Sing|NumForm=Word
ppron3:sg:inst:m3:ter:akc:praep	Animacy=Inan|Case=Ins|Gender=Masc|Number=Sing|Person=3|PrepCase=Pre|PronType=Prs|Variant=Long
ppron3:sg:acc:m1:ter:nakc:praep	Animacy=Hum|Case=Acc|Gender=Masc|Number=Sing|Person=3|PrepCase=Pre|PronType=Prs|Variant=Short
adj:sg:voc:m1:pos	Animacy=Hum|Case=Voc|Degree=Pos|Gender=Masc|Number=Sing
pact:pl:loc:f:imperf:aff	Aspect=Imp|Case=Loc|Gender=Fem|Number=Plur|Polarity=Pos|VerbForm=Part|Voice=Act
adj:pl:nom:m1:com	Animacy=Hum|Case=Nom|Degree=Cmp|Gender=Masc|Number=Plur
adj:pl:dat:m1:com	Animacy=Hum|Case=Dat|Degree=Cmp|Gender=Masc|Number=Plur
ppron12:sg:loc:f:pri	Case=Loc|Gender=Fem|Number=Sing|Person=1|PronType=Prs
adj:pl:acc:n:sup	Case=Acc|Degree=Sup|Gender=Neut|Number=Plur
ppron12:sg:gen:f:sec:akc	Case=Gen|Gender=Fem|Number=Sing|Person=2|PronType=Prs|Variant=Long
ppas:pl:gen:m3:perf:neg	Animacy=Inan|Aspect=Perf|Case=Gen|Gender=Masc|Number=Plur|Polarity=Neg|VerbForm=Part|Voice=Pass
ppas:sg:dat:m3:imperf:aff	Animacy=Inan|Aspect=Imp|Case=Dat|Gender=Masc|Number=Sing|Polarity=Pos|VerbForm=Part|Voice=Pass
num:pl:nom:f:rec:ncol	Case=Nom|Gender=Fem|Number=Plur|NumType=Card|PronType=Ind
num:pl:nom:m3:rec:ncol	Animacy=Inan|Case=Nom|Gender=Masc|Number=Plur|NumType=Card|PronType=Ind
adj:pl:acc:m3:sup	Animacy=Inan|Case=Acc|Degree=Sup|Gender=Masc|Number=Plur
ppas:sg:acc:f:imperf:neg	Aspect=Imp|Case=Acc|Gender=Fem|Number=Sing|Polarity=Neg|VerbForm=Part|Voice=Pass
ppron3:pl:inst:m3:ter:akc:praep	Animacy=Inan|Case=Ins|Gender=Masc|Number=Plur|Person=3|PrepCase=Pre|PronType=Prs|Variant=Long
adj:sg:dat:m2:pos	Animacy=Nhum|Case=Dat|Gender=Masc|Number=Sing|PronType=Dem
num:pl:inst:m1:congr:ncol	Animacy=Hum|Case=Ins|Gender=Masc|Number=Plur|NumForm=Word
ppas:pl:inst:m1:perf:aff	Animacy=Hum|Aspect=Perf|Case=Ins|Gender=Masc|Number=Plur|Polarity=Pos|VerbForm=Part|Voice=Pass
num:sg:acc:n:rec	Case=Acc|Gender=Neut|Number=Sing|NumType=Card|PronType=Ind
ppron3:pl:gen:n:ter:akc:npraep	Case=Gen|Gender=Neut|Number=Plur|Person=3|PrepCase=Npr|PronType=Prs|Variant=Long
num:pl:acc:f:congr:ncol	Case=Acc|Gender=Fem|Number=Plur|NumForm=Word
adj:sg:dat:n:com	Case=Dat|Degree=Cmp|Gender=Neut|Number=Sing
ppas:sg:nom:m3:perf:neg	Animacy=Inan|Aspect=Perf|Case=Nom|Gender=Masc|Number=Sing|Polarity=Neg|VerbForm=Part|Voice=Pass
adj:sg:loc:f:com	Case=Loc|Degree=Cmp|Gender=Fem|Number=Sing
num:pl:nom:m1:rec:ncol	Animacy=Hum|Case=Nom|Gender=Masc|Number=Plur|NumType=Card|PronType=Ind
pact:pl:inst:m3:imperf:aff	Animacy=Inan|Aspect=Imp|Case=Ins|Gender=Masc|Number=Plur|Polarity=Pos|VerbForm=Part|Voice=Act
pact:pl:nom:n:imperf:aff	Aspect=Imp|Case=Nom|Gender=Neut|Number=Plur|Polarity=Pos|VerbForm=Part|Voice=Act
num:pl:acc:m3:congr:ncol	Animacy=Inan|Case=Acc|Gender=Masc|Number=Plur|NumForm=Word
pact:pl:inst:n:imperf:aff	Aspect=Imp|Case=Ins|Gender=Neut|Number=Plur|Polarity=Pos|VerbForm=Part|Voice=Act
ppas:pl:acc:n:imperf:aff	Aspect=Imp|Case=Acc|Gender=Neut|Number=Plur|Polarity=Pos|VerbForm=Part|Voice=Pass
num:pl:gen:f:congr:ncol	Case=Gen|Gender=Fem|Number=Plur|NumForm=Word
bedzie:sg:sec:imperf	Aspect=Imp|Mood=Ind|Number=Sing|Person=2|Tense=Fut|VerbForm=Fin
ppas:pl:inst:f:imperf:aff	Aspect=Imp|Case=Ins|Gender=Fem|Number=Plur|Polarity=Pos|VerbForm=Part|Voice=Pass
ppas:pl:gen:n:imperf:aff	Aspect=Imp|Case=Gen|Gender=Neut|Number=Plur|Polarity=Pos|VerbForm=Part|Voice=Pass
subst:sg:gen:m3:col	Animacy=Inan|Case=Gen|Gender=Masc|Number=Sing
ppron3:sg:acc:n:ter:akc:npraep	Case=Acc|Gender=Neut|Number=Sing|Person=3|PrepCase=Npr|PronType=Prs|Variant=Long
ppas:sg:inst:m3:perf:aff	Animacy=Inan|Aspect=Perf|Case=Ins|Gender=Masc|Number=Sing|Polarity=Pos|VerbForm=Part|Voice=Pass
ppron12:sg:voc:m1:sec	Animacy=Hum|Case=Voc|Gender=Masc|Number=Sing|Person=2|PronType=Prs
num:pl:gen:m3:congr:ncol	Animacy=Inan|Case=Gen|Gender=Masc|Number=Plur|NumForm=Word
num:pl:nom:m3:congr:ncol	Animacy=Inan|Case=Nom|Gender=Masc|Number=Plur|NumForm=Word
num:pl:acc:m3:rec:ncol	Animacy=Inan|Case=Acc|Gender=Masc|Number=Plur|NumForm=Word
num:pl:acc:m3:rec:nol	Animacy=Inan|Case=Acc|Gender=Masc|Number=Plur|NumForm=Digit|NumType=Card
ppas:pl:acc:f:imperf:aff	Aspect=Imp|Case=Acc|Gender=Fem|Number=Plur|Polarity=Pos|VerbForm=Part|Voice=Pass
aglt:pl:sec:imperf:nwok	Aspect=Imp|Clitic=Yes|Number=Plur|Person=2|Variant=Short
ppron12:pl:acc:m1:sec	Animacy=Hum|Case=Acc|Gender=Masc|Number=Plur|Person=2|PronType=Prs
num:pl:inst:m3:congr:ncol	Animacy=Inan|Case=Ins|Gender=Masc|Number=Plur|NumForm=Word
subst:sg:nom:n	Case=Nom|Gender=Neut|Number=Sing
num:pl:acc:n:rec	Case=Acc|Gender=Neut|Number=Plur|NumType=Card|PronType=Ind
ppron12:sg:loc:m1:sec	Animacy=Hum|Case=Loc|Gender=Masc|Number=Sing|Person=2|PronType=Prs
ppas:pl:inst:n:imperf:aff	Aspect=Imp|Case=Ins|Gender=Neut|Number=Plur|Polarity=Pos|VerbForm=Part|Voice=Pass
ger:sg:dat:n:perf:aff	Aspect=Perf|Case=Dat|Gender=Neut|Number=Sing|Polarity=Pos|VerbForm=Vnoun
subst:sg:gen:m3:ncol	Animacy=Inan|Case=Gen|Gender=Masc|Number=Sing
ppron3:pl:inst:n:ter:akc:praep	Case=Ins|Gender=Neut|Number=Plur|Person=3|PrepCase=Pre|PronType=Prs|Variant=Long
num:pl:inst:f:congr:ncol	Case=Ins|Gender=Fem|Number=Plur|NumForm=Word
num:pl:gen:m1:congr:ncol	Animacy=Hum|Case=Gen|Gender=Masc|Number=Plur|NumForm=Word
adj:pl:gen:m1:com	Animacy=Hum|Case=Gen|Degree=Cmp|Gender=Masc|Number=Plur
ppron3:sg:loc:m3:ter:akc:npraep	Animacy=Inan|Case=Loc|Gender=Masc|Number=Sing|Person=3|PrepCase=Npr|PronType=Prs|Variant=Long
romandig	NumForm=Roman
ppron3:sg:gen:m3:ter:nakc:npraep	Animacy=Inan|Case=Gen|Gender=Masc|Number=Sing|Person=3|PrepCase=Npr|PronType=Prs|Variant=Short
adj:sg:gen:m1:com	Animacy=Hum|Case=Gen|Degree=Cmp|Gender=Masc|Number=Sing
ppas:pl:loc:n:perf:aff	Aspect=Perf|Case=Loc|Gender=Neut|Number=Plur|Polarity=Pos|VerbForm=Part|Voice=Pass
ppas:pl:inst:m3:perf:aff	Animacy=Inan|Aspect=Perf|Case=Ins|Gender=Masc|Number=Plur|Polarity=Pos|VerbForm=Part|Voice=Pass
adj:pl:inst:m2:pos	Animacy=Nhum|Case=Ins|Degree=Pos|Gender=Masc|Number=Plur
ppron3:pl:inst:m2:ter:akc:praep	Animacy=Nhum|Case=Ins|Gender=Masc|Number=Plur|Person=3|PrepCase=Pre|PronType=Prs|Variant=Long
pact:pl:inst:m1:imperf:aff	Animacy=Hum|Aspect=Imp|Case=Ins|Gender=Masc|Number=Plur|Polarity=Pos|VerbForm=Part|Voice=Act
adj:sg:gen:m2:com	Animacy=Nhum|Case=Gen|Degree=Cmp|Gender=Masc|Number=Sing
pact:sg:nom:n:imperf:aff	Aspect=Imp|Case=Nom|Gender=Neut|Number=Sing|Polarity=Pos|VerbForm=Part|Voice=Act
ppas:sg:loc:m2:perf:aff	Animacy=Nhum|Aspect=Perf|Case=Loc|Gender=Masc|Number=Sing|Polarity=Pos|VerbForm=Part|Voice=Pass
ppas:sg:inst:n:perf:aff	Aspect=Perf|Case=Ins|Gender=Neut|Number=Sing|Polarity=Pos|VerbForm=Part|Voice=Pass
pact:pl:gen:m2:imperf:aff	Animacy=Nhum|Aspect=Imp|Case=Gen|Gender=Masc|Number=Plur|Polarity=Pos|VerbForm=Part|Voice=Act
subst:sg:loc:n:col	Case=Loc|Gender=Neut|Number=Sing|NumType=Sets
pact:sg:acc:m2:imperf:aff	Animacy=Nhum|Aspect=Imp|Case=Acc|Gender=Masc|Number=Sing|Polarity=Pos|VerbForm=Part|Voice=Act
num:pl:nom:m1:rec:col	Animacy=Hum|Case=Nom|Gender=Masc|Number=Plur|NumForm=Word|NumType=Sets
praet:sg:m3:perf:nagl	Animacy=Inan|Aspect=Perf|Gender=Masc|Mood=Ind|Number=Sing|Tense=Past|VerbForm=Fin|Voice=Act
ppron12:sg:gen:f:pri:akc	Case=Gen|Gender=Fem|Number=Sing|Person=1|PronType=Prs|Variant=Long
adj:pl:gen:f:com	Case=Gen|Degree=Cmp|Gender=Fem|Number=Plur
ppron3:pl:acc:n:ter:akc:npraep	Case=Acc|Gender=Neut|Number=Plur|Person=3|PrepCase=Npr|PronType=Prs|Variant=Long
subst:pl:voc:n:ncol	Case=Voc|Gender=Neut|Number=Plur
ppron3:sg:gen:m2:ter:akc:npraep	Animacy=Nhum|Case=Gen|Gender=Masc|Number=Sing|Person=3|PrepCase=Npr|PronType=Prs|Variant=Long
ppron12:sg:dat:f:pri:akc	Case=Dat|Gender=Fem|Number=Sing|Person=1|PronType=Prs|Variant=Long
ppron3:pl:gen:m2:ter:akc:npraep	Animacy=Nhum|Case=Gen|Gender=Masc|Number=Plur|Person=3|PrepCase=Npr|PronType=Prs|Variant=Long
winien:sg:m2:imperf	Animacy=Nhum|Aspect=Imp|Gender=Masc|Mood=Ind|Number=Sing|Tense=Pres|VerbForm=Fin|VerbType=Mod|Voice=Act
num:pl:loc:n:congr:ncol	Case=Loc|Gender=Neut|Number=Plur|NumType=Card|PronType=Ind
adj:pl:inst:n:sup	Case=Ins|Degree=Sup|Gender=Neut|Number=Plur
pact:pl:inst:f:imperf:aff	Aspect=Imp|Case=Ins|Gender=Fem|Number=Plur|Polarity=Pos|VerbForm=Part|Voice=Act
ppron12:sg:nom:f:sec	Case=Nom|Gender=Fem|Number=Sing|Person=2|PronType=Prs
adj:pl:inst:f:com	Case=Ins|Degree=Cmp|Gender=Fem|Number=Plur
ppron3:pl:acc:m3:ter:akc:praep	Animacy=Inan|Case=Acc|Gender=Masc|Number=Plur|Person=3|PrepCase=Pre|PronType=Prs|Variant=Long
num:pl:dat:m3:congr	Animacy=Inan|Case=Dat|Gender=Masc|Number=Plur|NumForm=Digit|NumType=Card
pact:sg:dat:m1:imperf:aff	Animacy=Hum|Aspect=Imp|Case=Dat|Gender=Masc|Number=Sing|Polarity=Pos|VerbForm=Part|Voice=Act
num:sg:nom:f:rec	Case=Nom|Gender=Fem|Number=Sing|NumType=Card|PronType=Dem
adj:sg:nom:n:com	Case=Nom|Degree=Cmp|Gender=Neut|Number=Sing
subst:sg:voc:n:col	Case=Voc|Gender=Neut|Number=Sing|NumType=Sets
num:sg:nom:n:rec:ncol	Case=Nom|Gender=Neut|Number=Sing|NumType=Card|PronType=Ind
depr:sg:acc:m2	Animacy=Nhum|Case=Acc|Gender=Masc|NounForm=Depr|Number=Sing
subst:sg:voc:n:ncol	Case=Voc|Gender=Neut|Number=Sing
adj:pl:inst:f:sup	Case=Ins|Degree=Sup|Gender=Fem|Number=Plur
num:pl:gen:m1:rec:col	Animacy=Hum|Case=Gen|Gender=Masc|Number=Plur|NumForm=Word|NumType=Sets
ppron3:pl:inst:f:ter:akc:npraep	Case=Ins|Gender=Fem|Number=Plur|Person=3|PrepCase=Npr|PronType=Prs|Variant=Long
adj:pl:loc:m3:sup	Animacy=Inan|Case=Loc|Degree=Sup|Gender=Masc|Number=Plur
pact:pl:acc:m3:imperf:neg	Animacy=Inan|Aspect=Imp|Case=Acc|Gender=Masc|Number=Plur|Polarity=Neg|VerbForm=Part|Voice=Act
ppas:sg:loc:m3:imperf:aff	Animacy=Inan|Aspect=Imp|Case=Loc|Gender=Masc|Number=Sing|Polarity=Pos|VerbForm=Part|Voice=Pass
pact:sg:gen:m1:imperf:neg	Animacy=Hum|Aspect=Imp|Case=Gen|Gender=Masc|Number=Sing|Polarity=Neg|VerbForm=Part|Voice=Act
adj:sg:inst:n:sup	Case=Ins|Degree=Sup|Gender=Neut|Number=Sing
adj:pl:gen:n:sup	Case=Gen|Degree=Sup|Gender=Neut|Number=Plur
adj:sg:gen:m3:sup	Animacy=Inan|Case=Gen|Degree=Sup|Gender=Masc|Number=Sing
adj:pl:nom:f:com	Case=Nom|Degree=Cmp|Gender=Fem|Number=Plur
ppas:sg:gen:m3:perf:neg	Animacy=Inan|Aspect=Perf|Case=Gen|Gender=Masc|Number=Sing|Polarity=Neg|VerbForm=Part|Voice=Pass
adj:pl:acc:m3:com	Animacy=Inan|Case=Acc|Degree=Cmp|Gender=Masc|Number=Plur
ppas:sg:inst:m3:imperf:aff	Animacy=Inan|Aspect=Imp|Case=Ins|Gender=Masc|Number=Sing|Polarity=Pos|VerbForm=Part|Voice=Pass
num:pl:loc:m1:congr	Animacy=Hum|Case=Loc|Gender=Masc|Number=Plur|NumForm=Digit|NumType=Card
pact:pl:loc:m1:imperf:aff	Animacy=Hum|Aspect=Imp|Case=Loc|Gender=Masc|Number=Plur|Polarity=Pos|VerbForm=Part|Voice=Act
adj:pl:nom:n:sup	Case=Nom|Degree=Sup|Gender=Neut|Number=Plur
num:pl:dat:f:congr	Case=Dat|Gender=Fem|Number=Plur|NumType=Card|PronType=Ind
ppron3:pl:acc:n:ter:nakc:npraep	Case=Acc|Gender=Neut|Number=Plur|Person=3|PrepCase=Npr|PronType=Prs|Variant=Short
num:pl:dat:m1:congr	Animacy=Hum|Case=Dat|Gender=Masc|Number=Plur|NumForm=Word
ppron3:pl:dat:m2:ter:akc:npraep	Animacy=Nhum|Case=Dat|Gender=Masc|Number=Plur|Person=3|PrepCase=Npr|PronType=Prs|Variant=Long
pact:pl:gen:f:imperf:neg	Aspect=Imp|Case=Gen|Gender=Fem|Number=Plur|Polarity=Neg|VerbForm=Part|Voice=Act
num:pl:nom:n:congr:ncol	Case=Nom|Gender=Neut|Number=Plur|NumForm=Word
adj:pl:nom:m3:sup	Animacy=Inan|Case=Nom|Degree=Sup|Gender=Masc|Number=Plur
adj:sg:inst:f:sup	Case=Ins|Degree=Sup|Gender=Fem|Number=Sing
ppas:pl:gen:m2:imperf:aff	Animacy=Nhum|Aspect=Imp|Case=Gen|Gender=Masc|Number=Plur|Polarity=Pos|VerbForm=Part|Voice=Pass
ppas:pl:dat:f:perf:aff	Aspect=Perf|Case=Dat|Gender=Fem|Number=Plur|Polarity=Pos|VerbForm=Part|Voice=Pass
pact:pl:nom:m2:imperf:aff	Animacy=Nhum|Aspect=Imp|Case=Nom|Gender=Masc|Number=Plur|Polarity=Pos|VerbForm=Part|Voice=Act
adj:pl:dat:m1:sup	Animacy=Hum|Case=Dat|Degree=Sup|Gender=Masc|Number=Plur
ppron3:pl:dat:m1:ter:akc:praep	Animacy=Hum|Case=Dat|Gender=Masc|Number=Plur|Person=3|PrepCase=Pre|PronType=Prs|Variant=Long
ppas:sg:gen:m1:perf:neg	Animacy=Hum|Aspect=Perf|Case=Gen|Gender=Masc|Number=Sing|Polarity=Neg|VerbForm=Part|Voice=Pass
impt:sg:ter:perf	Aspect=Perf|Mood=Imp|Number=Sing|Person=3|VerbForm=Fin|Voice=Act
ppas:sg:acc:m3:perf:neg	Animacy=Inan|Aspect=Perf|Case=Acc|Gender=Masc|Number=Sing|Polarity=Neg|VerbForm=Part|Voice=Pass
adj:sg:inst:m3:com	Animacy=Inan|Case=Ins|Degree=Cmp|Gender=Masc|Number=Sing
pact:sg:dat:f:imperf:aff	Aspect=Imp|Case=Dat|Gender=Fem|Number=Sing|Polarity=Pos|VerbForm=Part|Voice=Act
ger:pl:inst:n:perf:aff	Aspect=Perf|Case=Ins|Gender=Neut|Number=Plur|Polarity=Pos|VerbForm=Vnoun
num:pl:dat:m1:congr:col	Animacy=Hum|Case=Dat|Gender=Masc|Number=Plur|NumType=Card|PronType=Ind
num:pl:acc:n:rec:col	Case=Acc|Gender=Neut|Number=Plur|NumForm=Word|NumType=Sets
subst:pl:inst:m1:pt	Animacy=Hum|Case=Ins|Gender=Masc|Number=Ptan
ppas:pl:nom:n:perf:neg	Aspect=Perf|Case=Nom|Gender=Neut|Number=Plur|Polarity=Neg|VerbForm=Part|Voice=Pass
ppron12:sg:acc:f:sec:akc	Case=Acc|Gender=Fem|Number=Sing|Person=2|PronType=Prs|Variant=Long
num:pl:gen:n:congr	Case=Gen|Gender=Neut|Number=Plur|NumForm=Digit|NumType=Card
num:pl:loc:f:congr:ncol	Case=Loc|Gender=Fem|Number=Plur|NumForm=Word
ppas:pl:gen:m2:perf:aff	Animacy=Nhum|Aspect=Perf|Case=Gen|Gender=Masc|Number=Plur|Polarity=Pos|VerbForm=Part|Voice=Pass
num:pl:dat:f:congr:ncol	Case=Dat|Gender=Fem|Number=Plur|NumForm=Word
pact:pl:loc:m3:imperf:aff	Animacy=Inan|Aspect=Imp|Case=Loc|Gender=Masc|Number=Plur|Polarity=Pos|VerbForm=Part|Voice=Act
ppas:pl:dat:n:perf:aff	Aspect=Perf|Case=Dat|Gender=Neut|Number=Plur|Polarity=Pos|VerbForm=Part|Voice=Pass
ppron3:sg:gen:n:ter:akc:praep	Case=Gen|Gender=Neut|Number=Sing|Person=3|PrepCase=Pre|PronType=Prs|Variant=Long
num:pl:gen:n:rec	Case=Gen|Gender=Neut|Number=Plur|NumType=Card|PronType=Ind
adj:sg:voc:f:pos	Case=Voc|Degree=Pos|Gender=Fem|Number=Sing
num:pl:loc:m3:congr:ncol	Animacy=Inan|Case=Loc|Gender=Masc|Number=Plur|NumForm=Word
subst:sg:inst:m3:ncol	Animacy=Inan|Case=Ins|Gender=Masc|Number=Sing
num:pl:nom:n:rec	Case=Nom|Gender=Neut|Number=Plur|NumType=Card|PronType=Ind
ppron3:sg:inst:m3:ter:akc:npraep	Animacy=Inan|Case=Ins|Gender=Masc|Number=Sing|Person=3|PrepCase=Npr|PronType=Prs|Variant=Long
ppron3:sg:loc:m2:ter:akc:praep	Animacy=Nhum|Case=Loc|Gender=Masc|Number=Sing|Person=3|PrepCase=Pre|PronType=Prs|Variant=Long
adj:pl:loc:m2:pos	Animacy=Nhum|Case=Loc|Degree=Pos|Gender=Masc|Number=Plur
pact:pl:acc:m2:imperf:aff	Animacy=Nhum|Aspect=Imp|Case=Acc|Gender=Masc|Number=Plur|Polarity=Pos|VerbForm=Part|Voice=Act
ppas:pl:nom:m2:imperf:aff	Animacy=Nhum|Aspect=Imp|Case=Nom|Gender=Masc|Number=Plur|Polarity=Pos|VerbForm=Part|Voice=Pass
num:pl:inst:m2:congr	Animacy=Nhum|Case=Ins|Gender=Masc|Number=Plur|NumForm=Word
adj:sg:inst:m1:com	Animacy=Hum|Case=Ins|Degree=Cmp|Gender=Masc|Number=Sing
ppas:pl:loc:n:imperf:aff	Aspect=Imp|Case=Loc|Gender=Neut|Number=Plur|Polarity=Pos|VerbForm=Part|Voice=Pass
ppas:sg:loc:m2:imperf:aff	Animacy=Nhum|Aspect=Imp|Case=Loc|Gender=Masc|Number=Sing|Polarity=Pos|VerbForm=Part|Voice=Pass
subst:sg:dat:n:col	Case=Dat|Gender=Neut|Number=Sing|NumType=Sets
ppron3:pl:gen:m2:ter:akc:praep	Animacy=Nhum|Case=Gen|Gender=Masc|Number=Plur|Person=3|PrepCase=Pre|PronType=Prs|Variant=Long
ppron3:sg:loc:n:ter:akc:praep	Case=Loc|Gender=Neut|Number=Sing|Person=3|PrepCase=Pre|PronType=Prs|Variant=Long
ppron3:sg:dat:m2:ter:nakc:npraep	Animacy=Nhum|Case=Dat|Gender=Masc|Number=Sing|Person=3|PrepCase=Npr|PronType=Prs|Variant=Short
pact:sg:dat:n:imperf:aff	Aspect=Imp|Case=Dat|Gender=Neut|Number=Sing|Polarity=Pos|VerbForm=Part|Voice=Act
ppron3:sg:dat:f:ter:nakc:npraep	Case=Dat|Gender=Fem|Number=Sing|Person=3|PrepCase=Npr|PronType=Prs|Variant=Short
adj:sg:inst:n:com	Case=Ins|Degree=Cmp|Gender=Neut|Number=Sing
ppas:pl:inst:m2:perf:aff	Animacy=Nhum|Aspect=Perf|Case=Ins|Gender=Masc|Number=Plur|Polarity=Pos|VerbForm=Part|Voice=Pass
ppas:sg:dat:m1:perf:aff	Animacy=Hum|Aspect=Perf|Case=Dat|Gender=Masc|Number=Sing|Polarity=Pos|VerbForm=Part|Voice=Pass
num:pl:inst:m1:congr	Animacy=Hum|Case=Ins|Gender=Masc|Number=Plur|NumForm=Word
ppron3:sg:dat:n:ter:nakc:npraep	Case=Dat|Gender=Neut|Number=Sing|Person=3|PrepCase=Npr|PronType=Prs|Variant=Short
adj:pl:acc:m1:sup	Animacy=Hum|Case=Acc|Degree=Sup|Gender=Masc|Number=Plur
ppas:sg:inst:f:imperf:neg	Aspect=Imp|Case=Ins|Gender=Fem|Number=Sing|Polarity=Neg|VerbForm=Part|Voice=Pass
adj:pl:acc:f:sup	Case=Acc|Degree=Sup|Gender=Fem|Number=Plur
ppas:sg:inst:n:perf:neg	Aspect=Perf|Case=Ins|Gender=Neut|Number=Sing|Polarity=Neg|VerbForm=Part|Voice=Pass
adj:pl:loc:m1:pos	Animacy=Hum|Case=Loc|Degree=Pos|Gender=Masc|Number=Plur
praet:sg:m1:perf:agl	Animacy=Hum|Aspect=Perf|Gender=Masc|Mood=Ind|Number=Sing|Tense=Past|VerbForm=Fin|Voice=Act
adj:pl:acc:m1:com	Animacy=Hum|Case=Acc|Degree=Cmp|Gender=Masc|Number=Plur
num:pl:dat:n:congr:ncol	Case=Dat|Gender=Neut|Number=Plur|NumType=Card|PronType=Ind
num:pl:inst:n:congr:ncol	Case=Ins|Gender=Neut|Number=Plur|NumType=Card|PronType=Ind
ppas:pl:dat:f:imperf:aff	Aspect=Imp|Case=Dat|Gender=Fem|Number=Plur|Polarity=Pos|VerbForm=Part|Voice=Pass
ppas:pl:loc:m1:imperf:aff	Animacy=Hum|Aspect=Imp|Case=Loc|Gender=Masc|Number=Plur|Polarity=Pos|VerbForm=Part|Voice=Pass
ppron12:pl:inst:m1:sec	Animacy=Hum|Case=Ins|Gender=Masc|Number=Plur|Person=2|PronType=Prs
praet:sg:m2:perf:nagl	Animacy=Nhum|Aspect=Perf|Gender=Masc|Mood=Ind|Number=Sing|Tense=Past|VerbForm=Fin|Voice=Act
adj:sg:loc:n:com	Case=Loc|Degree=Cmp|Gender=Neut|Number=Sing
adj:pl:loc:f:sup	Case=Loc|Degree=Sup|Gender=Fem|Number=Plur
depr:pl:voc:m2	Animacy=Nhum|Case=Voc|Gender=Masc|NounForm=Depr|Number=Plur
ppron3:pl:gen:m1:ter:nakc:npraep	Animacy=Hum|Case=Gen|Gender=Masc|Number=Plur|Person=3|PrepCase=Npr|PronType=Prs|Variant=Short
ppas:sg:nom:f:imperf:neg	Aspect=Imp|Case=Nom|Gender=Fem|Number=Sing|Polarity=Neg|VerbForm=Part|Voice=Pass
ppron3:sg:gen:n:ter:nakc:npraep	Case=Gen|Gender=Neut|Number=Sing|Person=3|PrepCase=Npr|PronType=Prs|Variant=Short
depr:pl:acc:m2	Animacy=Nhum|Case=Acc|Gender=Masc|NounForm=Depr|Number=Plur
adj:sg:acc:m1:com	Animacy=Hum|Case=Acc|Degree=Cmp|Gender=Masc|Number=Sing
pact:pl:dat:m3:imperf:aff	Animacy=Inan|Aspect=Imp|Case=Dat|Gender=Masc|Number=Plur|Polarity=Pos|VerbForm=Part|Voice=Act
ppas:pl:acc:m1:imperf:aff	Animacy=Hum|Aspect=Imp|Case=Acc|Gender=Masc|Number=Plur|Polarity=Pos|VerbForm=Part|Voice=Pass
ger:sg:nom:n:imperf:neg	Aspect=Imp|Case=Nom|Gender=Neut|Number=Sing|Polarity=Neg|VerbForm=Vnoun
ppron3:sg:dat:n:ter:akc:npraep	Case=Dat|Gender=Neut|Number=Sing|Person=3|PrepCase=Npr|PronType=Prs|Variant=Long
num:pl:acc:m1:rec:col	Animacy=Hum|Case=Acc|Gender=Masc|Number=Plur|NumForm=Word|NumType=Sets
ger:pl:gen:n:imperf:aff	Aspect=Imp|Case=Gen|Gender=Neut|Number=Plur|Polarity=Pos|VerbForm=Vnoun
pact:sg:nom:m1:imperf:neg	Animacy=Hum|Aspect=Imp|Case=Nom|Gender=Masc|Number=Sing|Polarity=Neg|VerbForm=Part|Voice=Act
ppron12:sg:gen:m1:pri	Animacy=Hum|Case=Gen|Gender=Masc|Number=Sing|Person=1|PronType=Prs
emo	_
num:sg:loc:m3:rec	Animacy=Inan|Case=Loc|Gender=Masc|Number=Sing|NumForm=Word
num:pl:gen:n:congr:col	Case=Gen|Gender=Neut|Number=Plur|NumType=Card|PronType=Ind
praet:pl:m1:imperf:agl	Animacy=Hum|Aspect=Imp|Gender=Masc|Mood=Ind|Number=Plur|Tense=Past|VerbForm=Fin|Voice=Act
adj:pl:inst:m3:com	Animacy=Inan|Case=Ins|Degree=Cmp|Gender=Masc|Number=Plur
ppas:sg:acc:f:perf:neg	Aspect=Perf|Case=Acc|Gender=Fem|Number=Sing|Polarity=Neg|VerbForm=Part|Voice=Pass
ign	Foreign=Yes
ppron12:sg:gen:m1:sec:nakc	Animacy=Hum|Case=Gen|Gender=Masc|Number=Sing|Person=2|PronType=Prs|Variant=Short
ppas:sg:nom:n:perf:neg	Aspect=Perf|Case=Nom|Gender=Neut|Number=Sing|Polarity=Neg|VerbForm=Part|Voice=Pass
adj:sg:gen:m1:sup	Animacy=Hum|Case=Gen|Degree=Sup|Gender=Masc|Number=Sing
ger:sg:nom:n:perf:neg	Aspect=Perf|Case=Nom|Gender=Neut|Number=Sing|Polarity=Neg|VerbForm=Vnoun
ger:pl:nom:n:perf:aff	Aspect=Perf|Case=Nom|Gender=Neut|Number=Plur|Polarity=Pos|VerbForm=Vnoun
ppas:sg:acc:m3:imperf:neg	Animacy=Inan|Aspect=Imp|Case=Acc|Gender=Masc|Number=Sing|Polarity=Neg|VerbForm=Part|Voice=Pass
ppas:sg:acc:m1:imperf:aff	Animacy=Hum|Aspect=Imp|Case=Acc|Gender=Masc|Number=Sing|Polarity=Pos|VerbForm=Part|Voice=Pass
num:pl:gen:n:rec:col	Case=Gen|Gender=Neut|Number=Plur|NumForm=Word|NumType=Sets
adj:sg:loc:m2:com	Animacy=Nhum|Case=Loc|Degree=Cmp|Gender=Masc|Number=Sing
adj:pl:gen:m2:sup	Animacy=Nhum|Case=Gen|Degree=Sup|Gender=Masc|Number=Plur
ppron12:sg:acc:m3:pri:akc	Animacy=Inan|Case=Acc|Gender=Masc|Number=Sing|Person=1|PronType=Prs|Variant=Long
ppron3:pl:nom:m2:ter:akc:npraep	Animacy=Nhum|Case=Nom|Gender=Masc|Number=Plur|Person=3|PrepCase=Npr|PronType=Prs|Variant=Long
ppas:sg:inst:m1:perf:neg	Animacy=Hum|Aspect=Perf|Case=Ins|Gender=Masc|Number=Sing|Polarity=Neg|VerbForm=Part|Voice=Pass
num:sg:gen:n:congr:ncol	Case=Gen|Gender=Neut|Number=Sing|NumType=Card|PronType=Ind
adj:pl:nom:m2:com	Animacy=Nhum|Case=Nom|Degree=Cmp|Gender=Masc|Number=Plur
adj:pl:loc:n:sup	Case=Loc|Degree=Sup|Gender=Neut|Number=Plur
pact:sg:voc:m1:imperf:aff	Animacy=Hum|Aspect=Imp|Case=Voc|Gender=Masc|Number=Sing|Polarity=Pos|VerbForm=Part|Voice=Act
ppron12:pl:loc:m1:pri	Animacy=Hum|Case=Loc|Gender=Masc|Number=Plur|Person=1|PronType=Prs
subst:sg:voc:m3	Animacy=Inan|Case=Voc|Gender=Masc|Number=Sing
ppron12:sg:nom:m2:sec	Animacy=Nhum|Case=Nom|Gender=Masc|Number=Sing|Person=2|PronType=Prs
ppas:pl:nom:m3:perf:neg	Animacy=Inan|Aspect=Perf|Case=Nom|Gender=Masc|Number=Plur|Polarity=Neg|VerbForm=Part|Voice=Pass
adj:pl:dat:m2:pos	Animacy=Nhum|Case=Dat|Gender=Masc|Number=Plur|Poss=Yes|PronType=Prs|Reflex=Yes
subst:pl:dat:m2	Animacy=Nhum|Case=Dat|Gender=Masc|Number=Plur
ppron3:pl:acc:f:ter:nakc:npraep	Case=Acc|Gender=Fem|Number=Plur|Person=3|PrepCase=Npr|PronType=Prs|Variant=Short
part:wok	_
ppas:pl:dat:m1:perf:aff	Animacy=Hum|Aspect=Perf|Case=Dat|Gender=Masc|Number=Plur|Polarity=Pos|VerbForm=Part|Voice=Pass
ppas:sg:nom:m3:imperf:neg	Animacy=Inan|Aspect=Imp|Case=Nom|Gender=Masc|Number=Sing|Polarity=Neg|VerbForm=Part|Voice=Pass
num:pl:loc:f:rec	Case=Loc|Gender=Fem|Number=Plur|NumForm=Digit|NumType=Card
ppron3:sg:acc:m1:ter:akc:npraep	Animacy=Hum|Case=Acc|Gender=Masc|Number=Sing|Person=3|PrepCase=Npr|PronType=Prs|Variant=Long
ppas:sg:gen:m3:imperf:neg	Animacy=Inan|Aspect=Imp|Case=Gen|Gender=Masc|Number=Sing|Polarity=Neg|VerbForm=Part|Voice=Pass
ppron3:pl:acc:m2:ter:akc:npraep	Animacy=Nhum|Case=Acc|Gender=Masc|Number=Plur|Person=3|PrepCase=Npr|PronType=Prs|Variant=Long
ppron3:pl:dat:f:ter:akc:praep	Case=Dat|Gender=Fem|Number=Plur|Person=3|PrepCase=Pre|PronType=Prs|Variant=Long
ppas:sg:loc:m1:perf:aff	Animacy=Hum|Aspect=Perf|Case=Loc|Gender=Masc|Number=Sing|Polarity=Pos|VerbForm=Part|Voice=Pass
ppas:sg:loc:m3:imperf:neg	Animacy=Inan|Aspect=Imp|Case=Loc|Gender=Masc|Number=Sing|Polarity=Neg|VerbForm=Part|Voice=Pass
ger:pl:dat:n:perf:aff	Aspect=Perf|Case=Dat|Gender=Neut|Number=Plur|Polarity=Pos|VerbForm=Vnoun
ppron12:sg:loc:f:sec	Case=Loc|Gender=Fem|Number=Sing|Person=2|PronType=Prs
adj:pl:loc:n:com	Case=Loc|Degree=Cmp|Gender=Neut|Number=Plur
ppas:sg:acc:n:perf:neg	Aspect=Perf|Case=Acc|Gender=Neut|Number=Sing|Polarity=Neg|VerbForm=Part|Voice=Pass
ppron3:sg:gen:m3:ter:nakc:praep	Animacy=Inan|Case=Gen|Gender=Masc|Number=Sing|Person=3|PrepCase=Pre|PronType=Prs|Variant=Short
ppas:sg:dat:m3:perf:aff	Animacy=Inan|Aspect=Perf|Case=Dat|Gender=Masc|Number=Sing|Polarity=Pos|VerbForm=Part|Voice=Pass
num:sg:gen:m3:congr	Animacy=Inan|Case=Gen|Gender=Masc|Number=Sing|NumForm=Word
ppron3:pl:dat:n:ter:akc:npraep	Case=Dat|Gender=Neut|Number=Plur|Person=3|PrepCase=Npr|PronType=Prs|Variant=Long
adj:pl:dat:n:sup	Case=Dat|Degree=Sup|Gender=Neut|Number=Plur
ppas:pl:gen:n:perf:neg	Aspect=Perf|Case=Gen|Gender=Neut|Number=Plur|Polarity=Neg|VerbForm=Part|Voice=Pass
ppron3:sg:inst:n:ter:akc:praep	Case=Ins|Gender=Neut|Number=Sing|Person=3|PrepCase=Pre|PronType=Prs|Variant=Long
pact:sg:acc:f:imperf:neg	Aspect=Imp|Case=Acc|Gender=Fem|Number=Sing|Polarity=Neg|VerbForm=Part|Voice=Act
ppas:pl:acc:f:perf:neg	Aspect=Perf|Case=Acc|Gender=Fem|Number=Plur|Polarity=Neg|VerbForm=Part|Voice=Pass
num:sg:gen:n:rec:ncol	Case=Gen|Gender=Neut|Number=Sing|NumType=Card|PronType=Ind
adj:sg:loc:f:sup	Case=Loc|Degree=Sup|Gender=Fem|Number=Sing
ppron12:sg:loc:m1:pri:akc	Animacy=Hum|Case=Loc|Gender=Masc|Number=Sing|Person=1|PronType=Prs|Variant=Long
num:pl:acc:m1:congr	Animacy=Hum|Case=Acc|Gender=Masc|Number=Plur|NumForm=Digit|NumType=Card
adj:pl:inst:m3:sup	Animacy=Inan|Case=Ins|Degree=Sup|Gender=Masc|Number=Plur
ppas:sg:dat:n:perf:aff	Aspect=Perf|Case=Dat|Gender=Neut|Number=Sing|Polarity=Pos|VerbForm=Part|Voice=Pass
ppron3:pl:loc:n:ter:akc:npraep	Case=Loc|Gender=Neut|Number=Plur|Person=3|PrepCase=Npr|PronType=Prs|Variant=Long
pact:pl:dat:n:imperf:aff	Aspect=Imp|Case=Dat|Gender=Neut|Number=Plur|Polarity=Pos|VerbForm=Part|Voice=Act
adj:pl:acc:m2:sup	Animacy=Nhum|Case=Acc|Degree=Sup|Gender=Masc|Number=Plur
adj:sg:voc:m2:pos	Animacy=Nhum|Case=Voc|Gender=Masc|Number=Sing|Number[psor]=Sing|Person=1|Poss=Yes|PronType=Prs
ppas:pl:nom:m1:perf:neg	Animacy=Hum|Aspect=Perf|Case=Nom|Gender=Masc|Number=Plur|Polarity=Neg|VerbForm=Part|Voice=Pass
ppas:sg:nom:m1:perf:neg	Animacy=Hum|Aspect=Perf|Case=Nom|Gender=Masc|Number=Sing|Polarity=Neg|VerbForm=Part|Voice=Pass
num:pl:gen:n:rec:ncol	Case=Gen|Gender=Neut|Number=Plur|NumType=Card|PronType=Ind
pact:sg:loc:m1:imperf:aff	Animacy=Hum|Aspect=Imp|Case=Loc|Gender=Masc|Number=Sing|Polarity=Pos|VerbForm=Part|Voice=Act
ppas:pl:acc:m3:perf:neg	Animacy=Inan|Aspect=Perf|Case=Acc|Gender=Masc|Number=Plur|Polarity=Neg|VerbForm=Part|Voice=Pass
num:pl:gen:f:rec	Case=Gen|Gender=Fem|Number=Plur|NumForm=Digit|NumType=Card
num:sg:gen:m2:congr	Animacy=Nhum|Case=Gen|Gender=Masc|Number=Sing|NumForm=Digit|NumType=Card
ppron3:sg:nom:m2:ter:akc:npraep	Animacy=Nhum|Case=Nom|Gender=Masc|Number=Sing|Person=3|PrepCase=Npr|PronType=Prs|Variant=Long
ppas:pl:acc:m2:imperf:aff	Animacy=Nhum|Aspect=Imp|Case=Acc|Gender=Masc|Number=Plur|Polarity=Pos|VerbForm=Part|Voice=Pass
ppron3:pl:gen:n:ter:nakc:npraep	Case=Gen|Gender=Neut|Number=Plur|Person=3|PrepCase=Npr|PronType=Prs|Variant=Short
ppron12:sg:loc:m3:pri	Animacy=Inan|Case=Loc|Gender=Masc|Number=Sing|Person=1|PronType=Prs
ppron3:pl:nom:n:ter:nakc:npraep	Case=Nom|Gender=Neut|Number=Plur|Person=3|PrepCase=Npr|PronType=Prs|Variant=Short
praet:sg:m2:imperf:nagl	Animacy=Nhum|Aspect=Imp|Gender=Masc|Mood=Ind|Number=Sing|Tense=Past|VerbForm=Fin|Voice=Act
ppas:sg:gen:n:imperf:neg	Aspect=Imp|Case=Gen|Gender=Neut|Number=Sing|Polarity=Neg|VerbForm=Part|Voice=Pass
ger:pl:dat:n:imperf:aff	Aspect=Imp|Case=Dat|Gender=Neut|Number=Plur|Polarity=Pos|VerbForm=Vnoun
ppron3:sg:acc:m2:ter:akc:praep	Animacy=Nhum|Case=Acc|Gender=Masc|Number=Sing|Person=3|PrepCase=Pre|PronType=Prs|Variant=Long
ger:pl:loc:n:perf:aff	Aspect=Perf|Case=Loc|Gender=Neut|Number=Plur|Polarity=Pos|VerbForm=Vnoun
ger:sg:inst:n:perf:neg	Aspect=Perf|Case=Ins|Gender=Neut|Number=Sing|Polarity=Neg|VerbForm=Vnoun
ppron3:sg:nom:m2:ter:akc:praep	Animacy=Nhum|Case=Nom|Gender=Masc|Number=Sing|Person=3|PrepCase=Pre|PronType=Prs|Variant=Long
ppas:pl:nom:f:perf:neg	Aspect=Perf|Case=Nom|Gender=Fem|Number=Plur|Polarity=Neg|VerbForm=Part|Voice=Pass
pact:pl:nom:n:imperf:neg	Aspect=Imp|Case=Nom|Gender=Neut|Number=Plur|Polarity=Neg|VerbForm=Part|Voice=Act
ppron3:pl:acc:m1:ter:nakc:npraep	Animacy=Hum|Case=Acc|Gender=Masc|Number=Plur|Person=3|PrepCase=Npr|PronType=Prs|Variant=Short
ppron3:pl:inst:m1:ter:akc:npraep	Animacy=Hum|Case=Ins|Gender=Masc|Number=Plur|Person=3|PrepCase=Npr|PronType=Prs|Variant=Long
adj:sg:dat:f:com	Case=Dat|Degree=Cmp|Gender=Fem|Number=Sing
adj:sg:acc:m2:com	Animacy=Nhum|Case=Acc|Degree=Cmp|Gender=Masc|Number=Sing
pact:pl:acc:n:imperf:neg	Aspect=Imp|Case=Acc|Gender=Neut|Number=Plur|Polarity=Neg|VerbForm=Part|Voice=Act
ppron3:sg:gen:m2:ter:nakc:npraep	Animacy=Nhum|Case=Gen|Gender=Masc|Number=Sing|Person=3|PrepCase=Npr|PronType=Prs|Variant=Short
ppron3:sg:dat:m3:ter:akc:praep	Animacy=Inan|Case=Dat|Gender=Masc|Number=Sing|Person=3|PrepCase=Pre|PronType=Prs|Variant=Long
num:pl:loc:m1:congr:col	Animacy=Hum|Case=Loc|Gender=Masc|Number=Plur|NumForm=Word|NumType=Sets
num:pl:gen:m2:rec	Animacy=Nhum|Case=Gen|Gender=Masc|Number=Plur|NumForm=Digit|NumType=Card
ppron12:sg:acc:m1:pri	Animacy=Hum|Case=Acc|Gender=Masc|Number=Sing|Person=1|PronType=Prs
num:sg:gen:f:rec	Case=Gen|Gender=Fem|Number=Sing|NumForm=Word
ppas:pl:gen:f:imperf:neg	Aspect=Imp|Case=Gen|Gender=Fem|Number=Plur|Polarity=Neg|VerbForm=Part|Voice=Pass
adj:pl:dat:f:com	Case=Dat|Degree=Cmp|Gender=Fem|Number=Plur
ppron3:sg:acc:m3:ter:akc:npraep	Animacy=Inan|Case=Acc|Gender=Masc|Number=Sing|Person=3|PrepCase=Npr|PronType=Prs|Variant=Long
adj:pl:dat:m3:com	Animacy=Inan|Case=Dat|Degree=Cmp|Gender=Masc|Number=Plur
ppron12:sg:acc:m2:pri:akc	Animacy=Nhum|Case=Acc|Gender=Masc|Number=Sing|Person=1|PronType=Prs|Variant=Long
ppron3:pl:acc:m3:ter:nakc:npraep	Animacy=Inan|Case=Acc|Gender=Masc|Number=Plur|Person=3|PrepCase=Npr|PronType=Prs|Variant=Short
ppas:sg:inst:m1:imperf:neg	Animacy=Hum|Aspect=Imp|Case=Ins|Gender=Masc|Number=Sing|Polarity=Neg|VerbForm=Part|Voice=Pass
ppron3:pl:inst:m2:ter:akc:npraep	Animacy=Nhum|Case=Ins|Gender=Masc|Number=Plur|Person=3|PrepCase=Npr|PronType=Prs|Variant=Long
num:sg:nom:m3:congr	Animacy=Inan|Case=Nom|Gender=Masc|Number=Sing|NumForm=Digit|NumType=Card
adj:sg:voc:n:pos	Case=Voc|Gender=Neut|Number=Sing|Number[psor]=Sing|Person=1|Poss=Yes|PronType=Prs
ppas:sg:inst:f:perf:neg	Aspect=Perf|Case=Ins|Gender=Fem|Number=Sing|Polarity=Neg|VerbForm=Part|Voice=Pass
adj:sg:dat:m3:com	Animacy=Inan|Case=Dat|Degree=Cmp|Gender=Masc|Number=Sing
adj:sg:gen:m2:sup	Animacy=Nhum|Case=Gen|Degree=Sup|Gender=Masc|Number=Sing
num:pl:nom:f:congr:ncol	Case=Nom|Gender=Fem|Number=Plur|NumForm=Word
ppas:sg:dat:n:imperf:aff	Aspect=Imp|Case=Dat|Gender=Neut|Number=Sing|Polarity=Pos|VerbForm=Part|Voice=Pass
num:pl:acc:f:rec:ncol	Case=Acc|Gender=Fem|Number=Plur|NumType=Card|PronType=Ind
ppas:pl:dat:n:imperf:aff	Aspect=Imp|Case=Dat|Gender=Neut|Number=Plur|Polarity=Pos|VerbForm=Part|Voice=Pass
subst:sg:gen:n	Case=Gen|Gender=Neut|Number=Sing
subst:sg:loc:m3:ncol	Animacy=Inan|Case=Loc|Gender=Masc|Number=Sing
ppron12:sg:gen:f:sec:nakc	Case=Gen|Gender=Fem|Number=Sing|Person=2|PronType=Prs|Variant=Short
num:pl:inst:m3:rec	Animacy=Inan|Case=Ins|Gender=Masc|Number=Plur|NumForm=Digit|NumType=Card
pact:pl:gen:m3:imperf:neg	Animacy=Inan|Aspect=Imp|Case=Gen|Gender=Masc|Number=Plur|Polarity=Neg|VerbForm=Part|Voice=Act
num:pl:acc:m1:rec:ncol	Animacy=Hum|Case=Acc|Gender=Masc|Number=Plur|NumForm=Word
subst:sg:loc:n	Case=Loc|Gender=Neut|Number=Sing
adj:sg:loc:m1:com	Animacy=Hum|Case=Loc|Degree=Cmp|Gender=Masc|Number=Sing
ppas:sg:gen:f:imperf:neg	Aspect=Imp|Case=Gen|Gender=Fem|Number=Sing|Polarity=Neg|VerbForm=Part|Voice=Pass
ppas:sg:loc:m3:perf:neg	Animacy=Inan|Aspect=Perf|Case=Loc|Gender=Masc|Number=Sing|Polarity=Neg|VerbForm=Part|Voice=Pass
ppron3:pl:inst:n:ter:akc:npraep	Case=Ins|Gender=Neut|Number=Plur|Person=3|PrepCase=Npr|PronType=Prs|Variant=Long
ppas:pl:inst:m3:imperf:aff	Animacy=Inan|Aspect=Imp|Case=Ins|Gender=Masc|Number=Plur|Polarity=Pos|VerbForm=Part|Voice=Pass
ppron3:pl:gen:f:ter:nakc:npraep	Case=Gen|Gender=Fem|Number=Plur|Person=3|PrepCase=Npr|PronType=Prs|Variant=Short
num:pl:nom:m1:congr:ncol	Animacy=Hum|Case=Nom|Gender=Masc|Number=Plur|NumForm=Word
ger:sg:loc:n:imperf:neg	Aspect=Imp|Case=Loc|Gender=Neut|Number=Sing|Polarity=Neg|VerbForm=Vnoun
subst:sg:nom:m3:ncol	Animacy=Inan|Case=Nom|Gender=Masc|Number=Sing
subst:pl:loc:n	Case=Loc|Gender=Neut|Number=Plur
ger:sg:inst:n:imperf:neg	Aspect=Imp|Case=Ins|Gender=Neut|Number=Sing|Polarity=Neg|VerbForm=Vnoun
adj:pl:voc:f:pos	Case=Voc|Degree=Pos|Gender=Fem|Number=Plur
subst:pl:voc:f	Case=Voc|Gender=Fem|Number=Plur
num:pl:gen:m2:congr:ncol	Animacy=Nhum|Case=Gen|Gender=Masc|Number=Plur|NumForm=Word
num:pl:loc:n:congr	Case=Loc|Gender=Neut|Number=Plur|NumType=Card|PronType=Ind
ppron12:sg:loc:f:pri:akc	Case=Loc|Gender=Fem|Number=Sing|Person=1|PronType=Prs|Variant=Long
num:pl:loc:m3:rec	Animacy=Inan|Case=Loc|Gender=Masc|Number=Plur|NumForm=Digit|NumType=Card
num:sg:nom:n:rec	Case=Nom|Gender=Neut|Number=Sing|NumType=Card|PronType=Ind
subst:sg:nom:n:pt	Case=Nom|Gender=Neut|Number=Ptan
ppas:pl:gen:n:imperf:neg	Aspect=Imp|Case=Gen|Gender=Neut|Number=Plur|Polarity=Neg|VerbForm=Part|Voice=Pass
num:sg:acc:m3	Animacy=Inan|Case=Acc|Gender=Masc|Number=Sing|NumForm=Digit|NumType=Card
adj:sg:voc:m3:pos	Animacy=Inan|Case=Voc|Degree=Pos|Gender=Masc|Number=Sing
num:pl:acc:n:congr	Case=Acc|Gender=Neut|Number=Plur|NumForm=Digit|NumType=Card
subst:sg:nom:m3:col	Animacy=Inan|Case=Nom|Gender=Masc|Number=Sing
