subst:pl:nom:f	NOUN
prep:loc:nwok	ADP
adj:pl:loc:m3:pos	ADJ
subst:pl:loc:m3	NOUN
conj	CCONJ
subst:pl:loc:f	NOUN
prep:loc	ADP
fin:pl:ter:imperf	VERB
adj:sg:loc:f:pos	ADJ
subst:sg:loc:f	NOUN
interp	PUNCT
subst:sg:nom:m2	NOUN
fin:sg:ter:imperf	VERB
prep:inst:nwok	ADP
adj:sg:inst:f:pos	ADJ
subst:sg:inst:f	NOUN
subst:sg:loc:m3	NOUN
num:pl:nom:f:congr	NUM
subst:pl:inst:n:pt	NOUN
adj:sg:nom:f:pos	ADJ
prep:gen:nwok	ADP
ppron3:pl:gen:f:ter:akc:praep	PRON
subst:sg:acc:f	NOUN
subst:sg:acc:m2	NOUN
adj:sg:nom:m1:pos	ADJ
subst:sg:nom:m1	NOUN
pcon:imperf	VERB
siebie:inst	PRON
adj:sg:acc:m3:pos	ADJ
subst:sg:acc:m3	NOUN
num:pl:nom:f:rec	DET
subst:pl:gen:f	NOUN
adj:pl:inst:m3:pos	ADJ
subst:pl:inst:m3	NOUN
subst:sg:nom:f	NOUN
ppas:pl:inst:n:perf:aff	ADJ
subst:pl:inst:n:ncol	NOUN
prep:acc:nwok	ADP
subst:sg:gen:n:ncol	NOUN
prep:dat	ADP
siebie:dat	PRON
adj:sg:nom:m2:pos	ADJ
prep:inst:wok	ADP
adj:sg:loc:m3:pos	ADJ
subst:pl:loc:m2	NOUN
prep:gen	ADP
ppas:sg:gen:f:perf:aff	ADJ
subst:sg:gen:f	NOUN
subst:sg:inst:m3	NOUN
adv	ADV
subst:sg:inst:m2	NOUN
subst:pl:loc:n:pt	NOUN
pact:sg:inst:m2:imperf:aff	ADJ
adj:pl:loc:n:pos	ADJ
num:pl:nom:n:rec:ncol	DET
subst:pl:gen:n:col	NOUN
ppas:sg:loc:f:perf:aff	ADJ
ppas:sg:loc:f:imperf:aff	ADJ
adj:pl:loc:f:pos	ADJ
ppas:sg:loc:n:imperf:aff	ADJ
subst:sg:loc:n:ncol	NOUN
prep:gen:wok	ADP
adj:sg:gen:f:pos	ADJ
adj:sg:inst:m3:pos	ADJ
ppas:sg:inst:f:perf:aff	ADJ
part	PART
pact:sg:gen:f:imperf:aff	ADJ
adj:sg:acc:m1:pos	ADJ
subst:sg:acc:m1	NOUN
prep:acc	ADP
subst:sg:acc:n:ncol	NOUN
num:pl:nom:m1:rec	NUM
subst:pl:gen:m1	NOUN
subst:sg:nom:n:col	NOUN
adja	ADJ
adj:sg:gen:m2:pos	ADJ
subst:sg:gen:m2	NOUN
num:pl:loc:f:congr	NUM
prep:inst	ADP
adj:sg:inst:m1:pos	ADJ
subst:pl:inst:f	NOUN
adj:sg:gen:m3:pos	ADJ
subst:sg:gen:m3	NOUN
adj:pl:gen:m1:pos	ADJ
pact:sg:acc:f:imperf:aff	ADJ
subst:sg:inst:n:col	NOUN
subst:pl:gen:m3	NOUN
adj:pl:inst:n:pos	ADJ
subst:pl:inst:n:col	NOUN
adv:pos	ADV
pact:sg:loc:n:imperf:aff	ADJ
adj:pl:nom:f:pos	ADJ
siebie:gen	PRON
ppas:sg:acc:m3:imperf:aff	ADJ
adj:sg:acc:n:pos	ADJ
adj:sg:gen:n:pos	ADJ
ppas:sg:nom:m2:perf:aff	ADJ
num:pl:nom:n:rec:col	NUM
num:pl:gen:f:congr	NUM
adj:pl:gen:f:pos	ADJ
pact:pl:gen:f:imperf:aff	ADJ
ppas:sg:loc:m3:perf:aff	ADJ
num:pl:nom:m2:congr	NUM
subst:pl:nom:m2	NOUN
ppas:pl:loc:m3:imperf:aff	ADJ
ppas:sg:nom:m1:perf:aff	ADJ
adj:pl:gen:n:pos	ADJ
pact:pl:gen:n:imperf:aff	ADJ
adj:sg:acc:f:pos	ADJ
ppas:sg:nom:f:perf:aff	ADJ
ppas:pl:gen:m1:perf:aff	ADJ
subst:pl:acc:n:ncol	NOUN
pact:pl:acc:n:imperf:aff	ADJ
ppas:sg:loc:n:perf:aff	ADJ
adj:sg:inst:n:pos	ADJ
subst:sg:inst:n:ncol	NOUN
num:pl:nom:m1:congr	NUM
subst:pl:nom:m1	NOUN
subst:pl:acc:f	NOUN
ppas:sg:nom:m1:imperf:aff	ADJ
adv:com	ADV
pact:sg:nom:f:imperf:aff	ADJ
ppron3:sg:gen:m2:ter:akc:praep	PRON
subst:pl:nom:m3	NOUN
subst:pl:loc:n:ncol	NOUN
ppas:pl:loc:m2:perf:aff	ADJ
ppas:pl:gen:f:perf:aff	ADJ
adj:sg:loc:n:pos	ADJ
pact:sg:nom:m1:imperf:aff	ADJ
adj:sg:nom:m3:pos	ADJ
subst:sg:nom:m3	NOUN
subst:pl:gen:n:ncol	NOUN
ppas:sg:nom:f:imperf:aff	ADJ
adj:pl:acc:m1:pos	ADJ
subst:pl:acc:m1	NOUN
ppron3:sg:inst:m1:ter:akc:praep	PRON
comp	SCONJ
adj:sg:inst:m2:pos	ADJ
subst:sg:acc:n:col	NOUN
pact:sg:acc:n:imperf:aff	ADJ
ppas:sg:inst:m2:perf:aff	ADJ
adj:sg:nom:f:com	ADJ
num:pl:inst:m3:congr	NUM
ppas:pl:loc:f:perf:aff	ADJ
ppron3:sg:gen:m1:ter:akc:praep	PRON
adj:sg:nom:m1:com	ADJ
subst:sg:inst:m1	NOUN
subst:sg:nom:n:ncol	NOUN
ppron3:sg:gen:f:ter:akc:praep	PRON
ppas:pl:inst:f:perf:aff	ADJ
subst:sg:loc:m2	NOUN
subst:pl:acc:m3	NOUN
adj:pl:nom:m3:pos	ADJ
ppas:pl:gen:n:perf:aff	ADJ
adj:pl:gen:m2:pos	ADJ
subst:pl:gen:m2	NOUN
adj:sg:nom:n:pos	ADJ
subst:sg:dat:m1	NOUN
ppron3:sg:acc:m3:ter:akc:praep	PRON
num:pl:acc:f:rec	DET
ppas:sg:gen:n:imperf:aff	ADJ
pact:pl:nom:f:imperf:aff	ADJ
ppron3:sg:dat:m1:ter:nakc:npraep	PRON
siebie:acc	PRON
ppron3:sg:gen:m1:ter:akc:npraep	PRON
adj:pl:acc:f:pos	ADJ
adj:pl:acc:n:pos	ADJ
num:pl:inst:n:rec:col	NUM
ppron3:pl:gen:n:ter:akc:praep	PRON
ppas:sg:nom:m3:perf:aff	ADJ
subst:sg:gen:m1	PROPN
ppas:sg:inst:m1:perf:aff	ADJ
adj:sg:gen:m1:pos	ADJ
adj:pl:nom:m1:pos	ADJ
ppron3:pl:gen:m1:ter:akc:npraep	PRON
subst:pl:acc:n:pt	NOUN
pact:sg:gen:m2:imperf:aff	ADJ
adjp	ADJ
ppas:sg:gen:m3:perf:aff	ADJ
imps:perf	VERB
inf:perf	VERB
subst:sg:dat:m2	NOUN
praet:sg:m3:imperf	VERB
praet:sg:f:perf	VERB
imps:imperf	VERB
num:pl:acc:m3:rec	NUM
pred	AUX
fin:pl:pri:imperf	VERB
inf:imperf	VERB
ppron12:sg:dat:m1:pri:akc	PRON
None	_
praet:sg:m1:perf	VERB
aglt:sg:pri:imperf:wok	AUX
num:sg:acc:n:rec:ncol	DET
fin:sg:pri:imperf	VERB
fin:pl:pri:perf	VERB
adv:sup	ADV
adj:pl:gen:m3:pos	ADJ
impt:sg:sec:imperf	VERB
ppron12:sg:nom:m1:pri	PRON
fin:sg:pri:perf	VERB
fin:sg:ter:perf	VERB
adj:pl:inst:f:pos	ADJ
fin:sg:sec:perf	VERB
fin:sg:sec:imperf	VERB
ppron12:pl:acc:m1:pri	PRON
subst:pl:nom:n:pt	NOUN
ppas:sg:acc:n:imperf:aff	ADJ
praet:sg:n:perf	VERB
praet:sg:n:imperf	VERB
pact:sg:gen:m1:imperf:aff	ADJ
aglt:sg:pri:imperf:nwok	AUX
praet:pl:m1:imperf	VERB
ppron3:sg:loc:f:ter:akc:praep	PRON
subst:pl:nom:m1:pt	PRON
praet:pl:m1:perf	VERB
aglt:pl:pri:imperf:nwok	AUX
impt:pl:pri:perf	VERB
adj:pl:acc:m3:pos	ADJ
praet:sg:f:imperf	VERB
praet:sg:m1:imperf	VERB
fin:pl:sec:imperf	VERB
ppron3:pl:dat:f:ter:akc:npraep	PRON
ger:sg:acc:n:imperf:aff	NOUN
bedzie:sg:ter:imperf	AUX
praet:pl:f:perf	VERB
ppron3:sg:nom:m3:ter:akc:npraep	PRON
praet:sg:m3:perf	VERB
num:pl:acc:m3:congr	NUM
praet:pl:n:perf	VERB
adj:pl:nom:n:pos	ADJ
subst:pl:inst:m1	NOUN
ppron3:sg:gen:f:ter:akc:npraep	PRON
ppas:sg:acc:f:perf:aff	ADJ
ppron3:pl:gen:m1:ter:akc:praep	PRON
num:pl:nom:m3:congr	NUM
ger:sg:acc:n:perf:aff	NOUN
prep:loc:wok	ADP
subst:pl:gen:n:pt	NOUN
praet:sg:m2:imperf	VERB
brev:npun	X
num:pl:acc:f:congr	NUM
praet:sg:m1:imperf:nagl	VERB
ppron3:sg:dat:f:ter:akc:npraep	PRON
num:pl:acc:m1:rec	NUM
num:pl:acc:n:rec:ncol	DET
ppron3:pl:acc:n:ter:akc:praep	PRON
num:pl:acc:m2:congr	NUM
subst:pl:acc:m2	NOUN
pact:pl:acc:m1:imperf:aff	ADJ
ppron3:pl:acc:f:ter:akc:npraep	PRON
subst:sg:dat:m3	NOUN
num:pl:loc:m3:congr	NUM
ger:pl:nom:n:imperf:aff	NOUN
praet:pl:m2:perf	VERB
subst:pl:dat:m1	NOUN
ppron3:sg:acc:m2:ter:nakc:npraep	PRON
subst:sg:dat:f	NOUN
ger:sg:loc:n:perf:aff	NOUN
num:pl:acc:m2:rec	NUM
prep:nom	ADP
ppron3:sg:dat:m3:ter:nakc:npraep	PRON
ppron3:sg:acc:f:ter:akc:npraep	PRON
praet:pl:m3:imperf	VERB
pact:sg:gen:m3:imperf:aff	ADJ
ppas:sg:acc:m3:perf:aff	ADJ
ppron12:sg:dat:m1:pri:nakc	PRON
ppron12:sg:dat:f:sec:nakc	PRON
ppron12:sg:acc:m1:sec:akc	PRON
ppron12:sg:acc:m1:pri:akc	PRON
ger:sg:loc:n:imperf:aff	NOUN
fin:pl:ter:perf	VERB
adj:sg:acc:m2:pos	ADJ
ppron3:sg:nom:m1:ter:akc:npraep	PRON
subst:pl:acc:n:col	NOUN
ppas:sg:gen:m2:perf:aff	ADJ
subst:sg:voc:m1	NOUN
winien:sg:m1:imperf	VERB
ppron12:sg:acc:f:pri:akc	PRON
ppron12:sg:dat:f:pri:nakc	PRON
aglt:sg:sec:imperf:nwok	AUX
subst:sg:voc:f	NOUN
impt:pl:pri:imperf	VERB
adj:sg:loc:m1:pos	DET
subst:sg:loc:m1	PROPN
ppron12:sg:loc:m1:pri	PRON
adj:sg:acc:m3:com	ADJ
ppron3:sg:gen:m1:ter:nakc:npraep	PRON
impt:sg:sec:perf	VERB
praet:pl:f:imperf	VERB
ppron3:sg:dat:m1:ter:akc:praep	PRON
praet:sg:m1:perf:nagl	VERB
bedzie:sg:pri:imperf	AUX
ppron3:sg:acc:m1:ter:nakc:npraep	PRON
impt:pl:sec:perf	VERB
fin:pl:sec:perf	VERB
ppron12:pl:inst:m1:pri	PRON
ppron12:pl:dat:m1:sec	PRON
adj:pl:nom:m2:pos	ADJ
praet:pl:n:imperf	VERB
ppron3:sg:loc:m1:ter:akc:praep	PRON
ppron3:sg:inst:f:ter:akc:praep	PRON
ppron3:pl:nom:m1:ter:akc:npraep	PRON
praet:sg:m2:perf	VERB
ger:sg:gen:n:imperf:aff	NOUN
ppron3:sg:acc:f:ter:akc:praep	PRON
adj:pl:inst:m1:pos	ADJ
num:pl:acc:n:congr:ncol	NUM
bedzie:pl:pri:imperf	AUX
impt:pl:sec:imperf	VERB
subst:pl:voc:n:pt	PROPN
adj:sg:loc:m2:pos	ADJ
ppron3:pl:acc:f:ter:akc:praep	PRON
ppron3:sg:nom:n:ter:akc:npraep	PRON
praet:pl:m3:perf	VERB
ger:sg:gen:n:perf:aff	NOUN
bedzie:pl:ter:imperf	AUX
ppron12:sg:nom:m1:sec	PRON
winien:pl:f:imperf	VERB
ppas:pl:nom:f:perf:aff	ADJ
subst:pl:nom:n:ncol	NOUN
pact:sg:acc:m3:imperf:aff	ADJ
ppron3:pl:acc:m3:ter:akc:npraep	PRON
ppron3:sg:loc:m3:ter:akc:praep	PRON
ppas:pl:acc:m2:perf:aff	ADJ
ppas:sg:nom:n:perf:aff	ADJ
adj:sg:dat:f:pos	ADJ
adj:sg:acc:m3:sup	ADJ
ppas:pl:nom:n:perf:aff	ADJ
ppron3:sg:acc:m3:ter:nakc:npraep	PRON
brev:pun	X
ppas:pl:nom:m3:perf:aff	ADJ
ppron12:pl:gen:m1:pri	PRON
ppron12:pl:nom:m1:pri	PRON
num:pl:inst:f:congr	NUM
frag	X
ppas:pl:nom:f:imperf:aff	ADJ
ppas:pl:acc:m3:perf:aff	ADJ
siebie:loc	PRON
adj:sg:nom:m3:com	ADJ
num:sg:gen:m3:rec	NUM
pact:sg:nom:m2:imperf:aff	ADJ
ppas:pl:gen:m1:imperf:aff	ADJ
ppas:pl:gen:f:perf:neg	ADJ
subst:pl:dat:m3	NOUN
ger:pl:gen:n:perf:aff	NOUN
ppas:sg:gen:m1:perf:aff	ADJ
ppas:pl:acc:m1:perf:aff	ADJ
adj:pl:inst:m1:sup	ADJ
winien:sg:f:imperf	VERB
pact:pl:gen:m1:imperf:aff	ADJ
subst:pl:dat:f	NOUN
adj:pl:dat:f:pos	ADJ
adj:pl:nom:f:sup	ADJ
adj:pl:dat:n:pos	ADJ
subst:pl:dat:n:ncol	NOUN
adj:sg:loc:n:sup	ADJ
pact:sg:inst:f:imperf:aff	ADJ
pant:perf	VERB
pact:pl:nom:m3:imperf:aff	ADJ
subst:pl:loc:n:col	NOUN
ger:sg:gen:n:perf:neg	NOUN
num:pl:nom:m3:rec	NUM
adj:sg:nom:m1:sup	ADJ
ppas:sg:gen:m1:imperf:aff	ADJ
dig	X
praet:sg:m3:imperf:nagl	VERB
ppron3:sg:dat:m1:ter:akc:npraep	PRON
ger:sg:nom:n:imperf:aff	NOUN
ppas:sg:acc:n:perf:aff	ADJ
ppron3:pl:gen:m3:ter:akc:npraep	PRON
ppas:sg:gen:f:imperf:aff	ADJ
subst:pl:inst:m2	NOUN
ppas:pl:nom:m3:imperf:aff	ADJ
num:pl:gen:m3:congr	NUM
ppas:pl:nom:n:imperf:aff	ADJ
ger:sg:nom:n:perf:aff	NOUN
ppas:pl:nom:m1:perf:aff	ADJ
ppas:sg:nom:m2:imperf:aff	ADJ
adj:pl:dat:m1:pos	DET
adj:sg:inst:f:com	ADJ
adj:sg:gen:f:com	ADJ
num:pl:gen:m1:congr	NUM
winien:pl:n:imperf	VERB
pact:sg:acc:m1:imperf:aff	ADJ
ppas:pl:gen:m3:perf:aff	ADJ
ppas:sg:inst:f:imperf:aff	ADJ
pact:pl:acc:f:imperf:aff	ADJ
ppas:sg:acc:f:imperf:aff	ADJ
ppron3:pl:acc:m1:ter:akc:npraep	PRON
ppas:pl:gen:m3:imperf:aff	ADJ
num:pl:nom:m2:rec	NUM
ppron3:sg:nom:f:ter:akc:npraep	PRON
ppron3:pl:dat:m3:ter:akc:npraep	PRON
adj:pl:dat:m3:pos	ADJ
ppron3:pl:dat:m1:ter:akc:npraep	PRON
ppron3:pl:loc:n:ter:akc:praep	PRON
interj	INTJ
ppron3:sg:dat:f:ter:akc:praep	PRON
bedzie:pl:sec:imperf	AUX
num:sg:acc:m3:rec	NUM
ppron3:pl:gen:f:ter:akc:npraep	PRON
ger:sg:inst:n:imperf:aff	NOUN
ppas:sg:nom:n:imperf:aff	ADJ
ppas:pl:gen:f:imperf:aff	ADJ
ppron3:pl:gen:m3:ter:akc:praep	PRON
adj:pl:loc:m3:com	ADJ
winien:sg:m3:imperf	VERB
winien:pl:m1:imperf	VERB
adj:pl:acc:m2:pos	ADJ
ppron3:sg:gen:m3:ter:akc:npraep	PRON
pact:sg:dat:m3:imperf:aff	ADJ
adj:sg:dat:m3:pos	ADJ
adj:sg:dat:f:sup	ADJ
ppron12:pl:gen:m1:sec	PRON
adj:pl:gen:m3:sup	ADJ
ppron3:pl:inst:m3:ter:akc:npraep	PRON
adj:pl:gen:n:com	ADJ
adj:sg:inst:m3:sup	ADJ
ppron3:sg:inst:n:ter:akc:npraep	PRON
ppas:sg:dat:f:perf:aff	ADJ
ppron12:sg:acc:f:sec:nakc	PRON
ppas:pl:loc:m3:perf:aff	ADJ
ppas:pl:acc:n:perf:aff	ADJ
subst:pl:nom:n:col	NOUN
ger:pl:acc:n:imperf:aff	NOUN
ppron3:pl:loc:f:ter:akc:praep	PRON
adj:sg:acc:n:com	ADJ
ppron3:pl:nom:f:ter:akc:npraep	PRON
winien:sg:n:imperf	VERB
ger:sg:inst:n:perf:aff	NOUN
ppron12:pl:dat:m1:pri	PRON
adj:sg:nom:n:sup	ADJ
adj:sg:dat:n:pos	ADJ
subst:sg:dat:n:ncol	NOUN
ppas:sg:nom:m3:imperf:aff	ADJ
pact:pl:acc:m3:imperf:aff	ADJ
adj:sg:inst:m1:sup	ADJ
pact:sg:nom:m3:imperf:aff	ADJ
pact:sg:gen:n:imperf:aff	ADJ
ppron3:pl:loc:m3:ter:akc:praep	PRON
subst:sg:gen:n:col	NOUN
aglt:sg:sec:imperf:wok	AUX
ppron12:sg:gen:m1:pri:akc	PRON
adj:sg:gen:f:sup	ADJ
ppas:sg:gen:n:perf:aff	ADJ
prep:acc:wok	ADP
adj:pl:acc:n:com	ADJ
ppron3:pl:inst:m1:ter:akc:praep	PRON
ppron3:pl:dat:m1:ter:nakc:npraep	PRON
ppron3:sg:gen:m3:ter:akc:praep	PRON
pact:pl:loc:n:imperf:aff	ADJ
ppron12:sg:inst:m1:sec	PRON
adj:pl:nom:m3:com	ADJ
subst:pl:dat:n:col	NOUN
ppron12:sg:dat:m1:sec:akc	PRON
praet:sg:m1:imperf:agl	VERB
pact:pl:dat:f:imperf:aff	ADJ
num:pl:gen:m2:congr	NUM
ppas:sg:nom:f:perf:neg	ADJ
praet:pl:m2:imperf	VERB
ppas:sg:gen:m3:imperf:aff	ADJ
adj:sg:loc:m3:com	ADJ
ger:pl:loc:n:imperf:aff	NOUN
ppas:sg:acc:m1:perf:aff	ADJ
ppron12:sg:dat:m1:sec:nakc	PRON
adj:pl:gen:f:sup	ADJ
adj:sg:loc:m3:sup	ADJ
adj:sg:dat:m1:pos	ADJ
adj:sg:gen:n:com	ADJ
pact:pl:gen:m3:imperf:aff	ADJ
ppron3:sg:inst:m2:ter:akc:praep	PRON
ppron3:pl:nom:m3:ter:akc:npraep	PRON
adj:sg:acc:f:sup	ADJ
adj:sg:nom:m3:sup	ADJ
winien:pl:m3:imperf	VERB
ppas:pl:acc:f:perf:aff	ADJ
pact:pl:nom:m1:imperf:aff	ADJ
pact:sg:loc:f:imperf:aff	ADJ
adj:pl:nom:n:com	ADJ
adj:sg:gen:m3:com	ADJ
ger:sg:dat:n:imperf:aff	NOUN
adj:pl:voc:m1:pos	ADJ
subst:pl:voc:m1	NOUN
subst:pl:acc:m1:pt	NOUN
adj:pl:gen:m3:com	ADJ
adj:pl:gen:m1:sup	ADJ
adj:pl:loc:m1:sup	ADJ
subst:pl:loc:m1	NOUN
adj:sg:acc:n:sup	ADJ
pact:sg:inst:m1:imperf:neg	ADJ
pact:sg:inst:m1:imperf:aff	ADJ
pact:pl:dat:m1:imperf:aff	ADJ
adj:sg:acc:f:com	ADJ
ppron12:pl:nom:m1:sec	PRON
ppron12:sg:inst:m1:pri	PRON
ppron3:sg:gen:n:ter:akc:npraep	PRON
subst:pl:gen:m1:pt	NOUN
ppas:pl:nom:m1:imperf:aff	ADJ
num:sg:acc:f:rec	NUM
pact:sg:inst:m3:imperf:aff	ADJ
num:pl:gen:n:congr:ncol	NUM
ppron3:pl:nom:n:ter:akc:npraep	PRON
ppron12:sg:gen:m1:sec:akc	PRON
ppron3:sg:acc:n:ter:akc:praep	PRON
ppas:pl:acc:m3:imperf:aff	ADJ
ppron12:sg:voc:m2:sec	PRON
subst:sg:voc:m2	NOUN
ppron3:sg:inst:m1:ter:akc:npraep	PRON
ppron12:sg:inst:f:sec	PRON
adj:pl:nom:m1:sup	ADJ
ppas:sg:inst:m1:imperf:aff	ADJ
ppron12:sg:nom:f:pri	PRON
subst:pl:dat:n:pt	PROPN
ppron3:pl:inst:f:ter:akc:praep	PRON
winien:pl:m2:imperf	VERB
adjc	ADJ
ger:sg:acc:n:perf:neg	NOUN
ppas:sg:dat:m1:imperf:aff	ADJ
subst:pl:loc:m1:pt	NOUN
depr:pl:nom:m2	NOUN
ppron3:sg:acc:m1:ter:akc:praep	PRON
ppas:sg:inst:n:imperf:aff	ADJ
ger:sg:acc:n:imperf:neg	NOUN
subst:pl:dat:m1:pt	NOUN
pact:sg:inst:n:imperf:aff	ADJ
pact:sg:loc:m3:imperf:aff	ADJ
adj:sg:acc:m2:sup	ADJ
ppas:sg:acc:m2:perf:aff	ADJ
adj:pl:loc:f:com	ADJ
ppron3:pl:acc:n:ter:nakc:praep	PRON
ppron3:pl:acc:m1:ter:akc:praep	PRON
ger:pl:acc:n:perf:aff	NOUN
ppron12:sg:inst:f:pri	PRON
ppron3:pl:loc:m1:ter:akc:praep	PRON
num:pl:gen:m3:rec	NUM
ppas:pl:nom:m2:perf:aff	ADJ
ppas:sg:gen:f:perf:neg	ADJ
ppron12:pl:acc:n:pri	PRON
ppron3:sg:acc:n:ter:nakc:npraep	PRON
ppron12:sg:acc:m1:sec:nakc	PRON
adj:sg:acc:m1:sup	ADJ
ger:sg:gen:n:imperf:neg	NOUN
ppas:pl:loc:f:imperf:aff	ADJ
adj:pl:acc:f:com	ADJ
num:sg:nom:m3:rec	DET
adj:sg:gen:n:sup	ADJ
adj:sg:nom:f:sup	ADJ
num:sg:loc:f:rec	NUM
ppron3:sg:inst:m3:ter:akc:praep	PRON
ppron3:sg:acc:m1:ter:nakc:praep	PRON
adj:sg:voc:m1:pos	ADJ
pact:pl:loc:f:imperf:aff	ADJ
adj:pl:nom:m1:com	ADJ
adj:pl:dat:m1:com	ADJ
ppron12:sg:loc:f:pri	PRON
adj:pl:acc:n:sup	ADJ
ppron12:sg:gen:f:sec:akc	PRON
ppas:pl:gen:m3:perf:neg	ADJ
ppas:sg:dat:m3:imperf:aff	ADJ
num:pl:nom:f:rec:ncol	DET
num:pl:nom:m3:rec:ncol	DET
adj:pl:acc:m3:sup	ADJ
ppas:sg:acc:f:imperf:neg	ADJ
ppron3:pl:inst:m3:ter:akc:praep	PRON
adj:sg:dat:m2:pos	DET
num:pl:inst:m1:congr:ncol	NUM
ppas:pl:inst:m1:perf:aff	ADJ
num:sg:acc:n:rec	DET
ppron3:pl:gen:n:ter:akc:npraep	PRON
num:pl:acc:f:congr:ncol	NUM
adj:sg:dat:n:com	ADJ
ppas:sg:nom:m3:perf:neg	ADJ
adj:sg:loc:f:com	ADJ
num:pl:nom:m1:rec:ncol	DET
pact:pl:inst:m3:imperf:aff	ADJ
pact:pl:nom:n:imperf:aff	ADJ
num:pl:acc:m3:congr:ncol	NUM
pact:pl:inst:n:imperf:aff	ADJ
ppas:pl:acc:n:imperf:aff	ADJ
num:pl:gen:f:congr:ncol	NUM
bedzie:sg:sec:imperf	AUX
ppas:pl:inst:f:imperf:aff	ADJ
ppas:pl:gen:n:imperf:aff	ADJ
subst:sg:gen:m3:col	PROPN
ppron3:sg:acc:n:ter:akc:npraep	PRON
ppas:sg:inst:m3:perf:aff	ADJ
ppron12:sg:voc:m1:sec	PRON
num:pl:gen:m3:congr:ncol	NUM
num:pl:nom:m3:congr:ncol	NUM
num:pl:acc:m3:rec:ncol	NUM
num:pl:acc:m3:rec:nol	NUM
ppas:pl:acc:f:imperf:aff	ADJ
aglt:pl:sec:imperf:nwok	AUX
ppron12:pl:acc:m1:sec	PRON
num:pl:inst:m3:congr:ncol	NUM
subst:sg:nom:n	PROPN
num:pl:acc:n:rec	DET
ppron12:sg:loc:m1:sec	PRON
ppas:pl:inst:n:imperf:aff	ADJ
ger:sg:dat:n:perf:aff	NOUN
subst:sg:gen:m3:ncol	PROPN
ppron3:pl:inst:n:ter:akc:praep	PRON
num:pl:inst:f:congr:ncol	NUM
num:pl:gen:m1:congr:ncol	NUM
adj:pl:gen:m1:com	ADJ
ppron3:sg:loc:m3:ter:akc:npraep	PRON
romandig	X
ppron3:sg:gen:m3:ter:nakc:npraep	PRON
adj:sg:gen:m1:com	ADJ
ppas:pl:loc:n:perf:aff	ADJ
ppas:pl:inst:m3:perf:aff	ADJ
adj:pl:inst:m2:pos	ADJ
ppron3:pl:inst:m2:ter:akc:praep	PRON
pact:pl:inst:m1:imperf:aff	ADJ
adj:sg:gen:m2:com	ADJ
pact:sg:nom:n:imperf:aff	ADJ
ppas:sg:loc:m2:perf:aff	ADJ
ppas:sg:inst:n:perf:aff	ADJ
pact:pl:gen:m2:imperf:aff	ADJ
subst:sg:loc:n:col	NOUN
pact:sg:acc:m2:imperf:aff	ADJ
num:pl:nom:m1:rec:col	DET
praet:sg:m3:perf:nagl	VERB
ppron12:sg:gen:f:pri:akc	PRON
adj:pl:gen:f:com	ADJ
ppron3:pl:acc:n:ter:akc:npraep	PRON
subst:pl:voc:n:ncol	NOUN
ppron3:sg:gen:m2:ter:akc:npraep	PRON
ppron12:sg:dat:f:pri:akc	PRON
ppron3:pl:gen:m2:ter:akc:npraep	PRON
winien:sg:m2:imperf	VERB
num:pl:loc:n:congr:ncol	DET
adj:pl:inst:n:sup	ADJ
pact:pl:inst:f:imperf:aff	ADJ
ppron12:sg:nom:f:sec	PRON
adj:pl:inst:f:com	ADJ
ppron3:pl:acc:m3:ter:akc:praep	PRON
num:pl:dat:m3:congr	NUM
pact:sg:dat:m1:imperf:aff	ADJ
num:sg:nom:f:rec	DET
adj:sg:nom:n:com	ADJ
subst:sg:voc:n:col	NOUN
num:sg:nom:n:rec:ncol	DET
depr:sg:acc:m2	NOUN
subst:sg:voc:n:ncol	NOUN
adj:pl:inst:f:sup	ADJ
num:pl:gen:m1:rec:col	NUM
ppron3:pl:inst:f:ter:akc:npraep	PRON
adj:pl:loc:m3:sup	ADJ
pact:pl:acc:m3:imperf:neg	ADJ
ppas:sg:loc:m3:imperf:aff	ADJ
pact:sg:gen:m1:imperf:neg	ADJ
adj:sg:inst:n:sup	ADJ
adj:pl:gen:n:sup	ADJ
adj:sg:gen:m3:sup	ADJ
adj:pl:nom:f:com	ADJ
ppas:sg:gen:m3:perf:neg	ADJ
adj:pl:acc:m3:com	ADJ
ppas:sg:inst:m3:imperf:aff	ADJ
num:pl:loc:m1:congr	NUM
pact:pl:loc:m1:imperf:aff	ADJ
adj:pl:nom:n:sup	ADJ
num:pl:dat:f:congr	NUM
ppron3:pl:acc:n:ter:nakc:npraep	PRON
num:pl:dat:m1:congr	NUM
ppron3:pl:dat:m2:ter:akc:npraep	PRON
pact:pl:gen:f:imperf:neg	ADJ
num:pl:nom:n:congr:ncol	NUM
adj:pl:nom:m3:sup	ADJ
adj:sg:inst:f:sup	ADJ
ppas:pl:gen:m2:imperf:aff	ADJ
ppas:pl:dat:f:perf:aff	ADJ
pact:pl:nom:m2:imperf:aff	ADJ
adj:pl:dat:m1:sup	ADJ
ppron3:pl:dat:m1:ter:akc:praep	PRON
ppas:sg:gen:m1:perf:neg	ADJ
impt:sg:ter:perf	VERB
ppas:sg:acc:m3:perf:neg	ADJ
adj:sg:inst:m3:com	ADJ
pact:sg:dat:f:imperf:aff	ADJ
ger:pl:inst:n:perf:aff	NOUN
num:pl:dat:m1:congr:col	DET
num:pl:acc:n:rec:col	NUM
subst:pl:inst:m1:pt	NOUN
ppas:pl:nom:n:perf:neg	ADJ
ppron12:sg:acc:f:sec:akc	PRON
num:pl:gen:n:congr	NUM
num:pl:loc:f:congr:ncol	NUM
ppas:pl:gen:m2:perf:aff	ADJ
num:pl:dat:f:congr:ncol	NUM
pact:pl:loc:m3:imperf:aff	ADJ
ppas:pl:dat:n:perf:aff	ADJ
ppron3:sg:gen:n:ter:akc:praep	PRON
num:pl:gen:n:rec	DET
adj:sg:voc:f:pos	ADJ
num:pl:loc:m3:congr:ncol	NUM
subst:sg:inst:m3:ncol	PROPN
num:pl:nom:n:rec	DET
ppron3:sg:inst:m3:ter:akc:npraep	PRON
ppron3:sg:loc:m2:ter:akc:praep	PRON
adj:pl:loc:m2:pos	ADJ
pact:pl:acc:m2:imperf:aff	ADJ
ppas:pl:nom:m2:imperf:aff	ADJ
num:pl:inst:m2:congr	NUM
adj:sg:inst:m1:com	ADJ
ppas:pl:loc:n:imperf:aff	ADJ
ppas:sg:loc:m2:imperf:aff	ADJ
subst:sg:dat:n:col	NOUN
ppron3:pl:gen:m2:ter:akc:praep	PRON
ppron3:sg:loc:n:ter:akc:praep	PRON
ppron3:sg:dat:m2:ter:nakc:npraep	PRON
pact:sg:dat:n:imperf:aff	ADJ
ppron3:sg:dat:f:ter:nakc:npraep	PRON
adj:sg:inst:n:com	ADJ
ppas:pl:inst:m2:perf:aff	ADJ
ppas:sg:dat:m1:perf:aff	ADJ
num:pl:inst:m1:congr	NUM
ppron3:sg:dat:n:ter:nakc:npraep	PRON
adj:pl:acc:m1:sup	ADJ
ppas:sg:inst:f:imperf:neg	ADJ
adj:pl:acc:f:sup	ADJ
ppas:sg:inst:n:perf:neg	ADJ
adj:pl:loc:m1:pos	ADJ
praet:sg:m1:perf:agl	VERB
adj:pl:acc:m1:com	ADJ
num:pl:dat:n:congr:ncol	DET
num:pl:inst:n:congr:ncol	DET
ppas:pl:dat:f:imperf:aff	ADJ
ppas:pl:loc:m1:imperf:aff	ADJ
ppron12:pl:inst:m1:sec	PRON
praet:sg:m2:perf:nagl	VERB
adj:sg:loc:n:com	ADJ
adj:pl:loc:f:sup	ADJ
depr:pl:voc:m2	NOUN
ppron3:pl:gen:m1:ter:nakc:npraep	PRON
ppas:sg:nom:f:imperf:neg	ADJ
ppron3:sg:gen:n:ter:nakc:npraep	PRON
depr:pl:acc:m2	NOUN
adj:sg:acc:m1:com	ADJ
pact:pl:dat:m3:imperf:aff	ADJ
ppas:pl:acc:m1:imperf:aff	ADJ
ger:sg:nom:n:imperf:neg	NOUN
ppron3:sg:dat:n:ter:akc:npraep	PRON
num:pl:acc:m1:rec:col	NUM
ger:pl:gen:n:imperf:aff	NOUN
pact:sg:nom:m1:imperf:neg	ADJ
ppron12:sg:gen:m1:pri	PRON
emo	SYM
num:sg:loc:m3:rec	NUM
num:pl:gen:n:congr:col	DET
praet:pl:m1:imperf:agl	VERB
adj:pl:inst:m3:com	ADJ
ppas:sg:acc:f:perf:neg	ADJ
ign	X
ppron12:sg:gen:m1:sec:nakc	PRON
ppas:sg:nom:n:perf:neg	ADJ
adj:sg:gen:m1:sup	ADJ
ger:sg:nom:n:perf:neg	NOUN
ger:pl:nom:n:perf:aff	NOUN
ppas:sg:acc:m3:imperf:neg	ADJ
ppas:sg:acc:m1:imperf:aff	ADJ
num:pl:gen:n:rec:col	NUM
adj:sg:loc:m2:com	ADJ
adj:pl:gen:m2:sup	ADJ
ppron12:sg:acc:m3:pri:akc	PRON
ppron3:pl:nom:m2:ter:akc:npraep	PRON
ppas:sg:inst:m1:perf:neg	ADJ
num:sg:gen:n:congr:ncol	DET
adj:pl:nom:m2:com	ADJ
adj:pl:loc:n:sup	ADJ
pact:sg:voc:m1:imperf:aff	ADJ
ppron12:pl:loc:m1:pri	PRON
subst:sg:voc:m3	NOUN
ppron12:sg:nom:m2:sec	PRON
ppas:pl:nom:m3:perf:neg	ADJ
adj:pl:dat:m2:pos	DET
subst:pl:dat:m2	NOUN
ppron3:pl:acc:f:ter:nakc:npraep	PRON
part:wok	PART
ppas:pl:dat:m1:perf:aff	ADJ
ppas:sg:nom:m3:imperf:neg	ADJ
num:pl:loc:f:rec	NUM
ppron3:sg:acc:m1:ter:akc:npraep	PRON
ppas:sg:gen:m3:imperf:neg	ADJ
ppron3:pl:acc:m2:ter:akc:npraep	PRON
ppron3:pl:dat:f:ter:akc:praep	PRON
ppas:sg:loc:m1:perf:aff	ADJ
ppas:sg:loc:m3:imperf:neg	ADJ
ger:pl:dat:n:perf:aff	NOUN
ppron12:sg:loc:f:sec	PRON
adj:pl:loc:n:com	ADJ
ppas:sg:acc:n:perf:neg	ADJ
ppron3:sg:gen:m3:ter:nakc:praep	PRON
ppas:sg:dat:m3:perf:aff	ADJ
num:sg:gen:m3:congr	NUM
ppron3:pl:dat:n:ter:akc:npraep	PRON
adj:pl:dat:n:sup	ADJ
ppas:pl:gen:n:perf:neg	ADJ
ppron3:sg:inst:n:ter:akc:praep	PRON
pact:sg:acc:f:imperf:neg	ADJ
ppas:pl:acc:f:perf:neg	ADJ
num:sg:gen:n:rec:ncol	DET
adj:sg:loc:f:sup	ADJ
ppron12:sg:loc:m1:pri:akc	PRON
num:pl:acc:m1:congr	NUM
adj:pl:inst:m3:sup	ADJ
ppas:sg:dat:n:perf:aff	ADJ
ppron3:pl:loc:n:ter:akc:npraep	PRON
pact:pl:dat:n:imperf:aff	ADJ
adj:pl:acc:m2:sup	ADJ
adj:sg:voc:m2:pos	DET
ppas:pl:nom:m1:perf:neg	ADJ
ppas:sg:nom:m1:perf:neg	ADJ
num:pl:gen:n:rec:ncol	DET
pact:sg:loc:m1:imperf:aff	ADJ
ppas:pl:acc:m3:perf:neg	ADJ
num:pl:gen:f:rec	NUM
num:sg:gen:m2:congr	NUM
ppron3:sg:nom:m2:ter:akc:npraep	PRON
ppas:pl:acc:m2:imperf:aff	ADJ
ppron3:pl:gen:n:ter:nakc:npraep	PRON
ppron12:sg:loc:m3:pri	PRON
ppron3:pl:nom:n:ter:nakc:npraep	PRON
praet:sg:m2:imperf:nagl	VERB
ppas:sg:gen:n:imperf:neg	ADJ
ger:pl:dat:n:imperf:aff	NOUN
ppron3:sg:acc:m2:ter:akc:praep	PRON
ger:pl:loc:n:perf:aff	NOUN
ger:sg:inst:n:perf:neg	NOUN
ppron3:sg:nom:m2:ter:akc:praep	PRON
ppas:pl:nom:f:perf:neg	ADJ
pact:pl:nom:n:imperf:neg	ADJ
ppron3:pl:acc:m1:ter:nakc:npraep	PRON
ppron3:pl:inst:m1:ter:akc:npraep	PRON
adj:sg:dat:f:com	ADJ
adj:sg:acc:m2:com	ADJ
pact:pl:acc:n:imperf:neg	ADJ
ppron3:sg:gen:m2:ter:nakc:npraep	PRON
ppron3:sg:dat:m3:ter:akc:praep	PRON
num:pl:loc:m1:congr:col	NUM
num:pl:gen:m2:rec	NUM
ppron12:sg:acc:m1:pri	PRON
num:sg:gen:f:rec	NUM
ppas:pl:gen:f:imperf:neg	ADJ
adj:pl:dat:f:com	ADJ
ppron3:sg:acc:m3:ter:akc:npraep	PRON
adj:pl:dat:m3:com	ADJ
ppron12:sg:acc:m2:pri:akc	PRON
ppron3:pl:acc:m3:ter:nakc:npraep	PRON
ppas:sg:inst:m1:imperf:neg	ADJ
ppron3:pl:inst:m2:ter:akc:npraep	PRON
num:sg:nom:m3:congr	NUM
adj:sg:voc:n:pos	DET
ppas:sg:inst:f:perf:neg	ADJ
adj:sg:dat:m3:com	ADJ
adj:sg:gen:m2:sup	ADJ
num:pl:nom:f:congr:ncol	NUM
ppas:sg:dat:n:imperf:aff	ADJ
num:pl:acc:f:rec:ncol	DET
ppas:pl:dat:n:imperf:aff	ADJ
subst:sg:gen:n	PROPN
subst:sg:loc:m3:ncol	PROPN
ppron12:sg:gen:f:sec:nakc	PRON
num:pl:inst:m3:rec	NUM
pact:pl:gen:m3:imperf:neg	ADJ
num:pl:acc:m1:rec:ncol	NUM
subst:sg:loc:n	PROPN
adj:sg:loc:m1:com	ADJ
ppas:sg:gen:f:imperf:neg	ADJ
ppas:sg:loc:m3:perf:neg	ADJ
ppron3:pl:inst:n:ter:akc:npraep	PRON
ppas:pl:inst:m3:imperf:aff	ADJ
ppron3:pl:gen:f:ter:nakc:npraep	PRON
num:pl:nom:m1:congr:ncol	NUM
ger:sg:loc:n:imperf:neg	NOUN
subst:sg:nom:m3:ncol	PROPN
subst:pl:loc:n	NOUN
ger:sg:inst:n:imperf:neg	NOUN
adj:pl:voc:f:pos	ADJ
subst:pl:voc:f	NOUN
num:pl:gen:m2:congr:ncol	NUM
num:pl:loc:n:congr	DET
ppron12:sg:loc:f:pri:akc	PRON
num:pl:loc:m3:rec	NUM
num:sg:nom:n:rec	DET
subst:sg:nom:n:pt	NOUN
ppas:pl:gen:n:imperf:neg	ADJ
num:sg:acc:m3	NUM
adj:sg:voc:m3:pos	ADJ
num:pl:acc:n:congr	NUM
subst:sg:nom:m3:col	PROPN
